border_size=1
usage=map

Gs^Fds, Gs^Fds, Gs^Fds, Gs^Fds, Gs^Fds, Gs^Fds, Gs^Fds, Gs^Fds, Gs^Fds, Gs^Fds, Gs^Fds, Gs^Fds, Gs^Fds, Gs^Fds, Gs^Fds, Gs^Fds, Gs^Fds, Gs^Fds, Gs^Fds, Gs^Fds, Gs^Fds, Gs^Fds, Gs^Fds, Gs^Fds, Gs^Fds, Gs^Fds, Gs^Fds, Gs^Fds, Gs^Fds, Gs^Fds
Gs^Fds, Gs^Fds, Gs^Fds, Gs^Fds, Gs^Fds, Gs^Fds, Gs^Fds, Gs^Fds, Gs^Fds, Gs^Fds, Gs^Fds, Gs^Fds, Gs^Fds, Gs^Fds, Gs^Fds, Gs^Fds, Gs^Fds, Gs^Fds, Gs^Fds, Gs^Fds, Gs^Fds, Gs^Fds, Gs^Fds, Gs^Fds, Gs^Fds, Gs^Fds, Gs^Fds, Gs^Fds, Gs^Fds, Gs^Fds
Gs^Fds, Gs^Fds, Gs^Fds, Gs^Fds, Gs^Fds, Gs^Fds, Gs^Fds, Gs^Fds, Gs^Fds, Gs^Fds, Gs^Fds, Gs^Fds, Gg^Ve, Gs^Fds, Gs^Fds, Gs^Fds, Gs^Fds, Gs^Fds, Gs^Fds, Gs^Fds, Gs^Fds, Gs^Fds, Gs^Fds, Gs^Fds, Gs^Fds, Gs^Fds, Gs^Fds, Gs^Fds, Gs^Fds, Gs^Fds
Gs^Fds, Gs^Fds, Gs^Fds, Gs^Fds, Gs^Fds, Gs^Fds, Gs^Fds, Gs^Fds, Gs^Fds, Gg^Ve, Cv, Cv, Cv, Gs^Fds, Gs^Fds, Gs^Fds, Gs^Fds, Gs^Fds, Gs^Fds, Gs^Fds, Gs^Fds, Gs^Fds, Gs^Fds, Gs^Fds, Gs^Fds, Gs^Fds, Gs^Fds, Gs^Fds, Gs^Fds, Gs^Fds
Gs^Fds, Gs^Fds, Gs^Fds, Gs^Fds, Gs^Fds, Gs^Fds, Gs^Fds, Gs^Fds, Gs^Fds, Gg^Efm, Cv, 2 Kv, Cv, Gs^Fds, Gs^Fds, Gs^Fds, Gs^Fds, Gs^Fds, Gs^Fds, Gs^Fds, Gs^Fds, Gs^Fds, Gs^Fds, Gs^Fds, Gg, Gs^Fds, Gs^Fds, Gs^Fds, Gs^Fds, Gs^Fds
Gs^Fds, Gs^Fds, Gs^Fds, Gs^Fds, Gs^Fds, Gs^Fds, Gg^Efm, Gs^Fds, Gg^Efm, Re, Gg^Efm, Cv, Re, Gg^Efm, Gg^Efm, Gs^Fds, Gg^Efm, Gg^Efm, Gg^Efm, Gg^Ve, Gg^Efm, Gs^Fds, Gg, Gg, Gg, Gs, Gs, Gs^Fds, Gs, Gs
Gs^Fds, Gs^Fds, Gg^Efm, Gg^Efm, Gg^Efm, Gg^Efm, Gg^Efm, Gg^Efm, Gg^Efm, Re, Re, Gg^Efm, Re, Gg^Efm, Gg^Efm, Gg^Efm, Gg^Gvs, Gg^Gvs, Gg^Gvs, Gg^Efm, Gg^Efm, Gg, Gg, Gg, Gg, Gs, Gs, Gs, Gs, Gs
Gg^Efm, Gs^Fds, Gg^Efm, Gg^Efm, Re, Gg^Efm, Re, Re, Re, Gg^Efm, Gg^Efm, Re, Re, Gg^Efm, Gg^Efm, Gg^Gvs, Gg^Gvs, Gg^Gvs, Gg^Gvs, Gg^Gvs, Gg, Gg, Gg, Gg, Gd, Gs, Gd, Gs, Gd, Gs
Re, Gg^Efm, Re, Re, Gg^Efm, Re, Gg^Efm, Gg^Efm, Gg^Efm, Re, Re, Gg^Efm, Re, Gg^Efm, Gg^Efm, Gg^Efm, Gg^Efm, Gg^Gvs, Gg^Wm, Gg, Gg, Gg, Gd, Gd, Gd, Gd, Gd, Gd, Gd, Gd
Gg^Efm, Re, Gg^Efm, Gg^Efm, Gg^Gvs, Gg^Gvs, Gg^Gvs, Gg^Efm, Gg^Efm, Gg^Efm, Re, Re, Gg^Efm, Gg^Ve, Re, Gg^Efm, Re, Re, Gg, Re, Re, Gd^Vhr, Gd, Gd, Gd, Gd, Gd, Gd, Gd, Gd
Gg^Efm, Gg^Efm, Gg^Efm, Gg^Gvs, Gg^Gvs, Gg^Gvs, Gg^Gvs, Gg^Gvs, Gg^Efm, Gg^Efm, Re, Gg^Efm, Gg^Efm, Gg^Efm, Gg^Efm, Re, Gg^Efm, Gg^Efm, Gd, Gd, Re, Gd, Gd, Gd, Gd, Gd, Gd, Gd, Gd, Gd
Gg, Gg^Efm, Gg^Efm, Gg^Efm, Gg^Efm, Gg^Gvs, Gg, Gg^Wm, Re, Gg^Efm, Gg^Ve, Gg^Efm, Gg^Efm, Gg^Efm, Gg^Efm, Gg^Efm, Gg^Efm, Gd, Gd, Gd, Gd, Gd^Vhr, Re, Gd, Ss, Ss, Ss, Gd, Gd, Gd
Gg^Efm, Gg^Efm, Gg^Efm, Gg^Efm, Gg, Gg, Gg, Gg, Gg, Re, Gg, Gg, Gg^Gvs, Gg^Efm, Gg^Wm, Gg^Efm, Gg, Gd, Gd, Gd, Gd, Gd, Ss, Ss, Ss, Ss, Ss, Ss, Ss, Gd
Gg^Efm, Gg^Efm, Gg, Gg, Gg, Gg, Gg, Gg, Gg, Re, Gg^Gvs, Gg^Gvs, Gg^Gvs, Gg^Gvs, Gg^Gvs, Re, Gg, Gd, Gd, Gd, Gd, Ss, Ss, Ss, Chs, Ss^Vhs, Ss, Ss, Ss, Gd
Gg, Gg, Gg, Gg, Gg, Gg, Gg, Gg, Gg, Re, Gg, Gg^Gvs, Gg^Gvs, Gg^Gvs, Re, Re, Gg, Gd, Gd, Gd, Gd, Ss, Ss, Chs, 3 Khs, Chs, Ss, Ss, Ss, Gd
Gg, Gg, Gg, Gg, Gg, Gg, Gg, Gg, Gg, Re, Gg, Gg, Gg, Gg, Re, Gg, Gs, Gd, Gd^Vhr, Gd, Gd, Ss, Ss, Chs, Chs, Chs, Ss^Vhs, Ss, Ss, Gd
Gg, Gg, Gg, Gg, Gg, Gg, Gg, Gg, Gg, Re, Gg, Gg, Re, Re, Gs, Gs, Gs, Gs, Gd, Gd, Gd, Ss, Ss, Ss^Vhs, Ss, Ss, Ss, Ss, Ss, Gd
Gs, Gg, Gs, Gg, Gg, Gg, Gg, Gg, Gg, Re, Re, Re, Gs, Gs, Gs, Gs, Gs, Gs, Gd, Gd, Gd, Gd, Gd, Ss, Ss, Ss, Ss, Ss, Gd, Gd
Gs, Gs, Gs, Gs, Gg, Gg, Gg, Gg, Gg, Re, Gs, Gs, Gs, Gs, Gs, Gs, Gs, Gs, Gd, Gd, Gd, Gd^Vhr, Gd, Gd, Re, Ss, Gd, Gd, Gd, Gd
Gs, Gs, Gs, Gs, Gs, Gg, Re, Gg, Gg, Re, Gs, Gs, Gs, Gs, Gs, Gs, Gs, Gs, Gs, Gd, Gd, Gd, Gd, Gd, Re, Gd, Gd, Gd, Gd, Gd
Re, Gs, Re, Re, Re, Re, Gg, Re, Re, Re, Gg, Gs, Gs, Gs, Gs, Gs, Gs, Gs, Gg, Gd, Gd, Gd, Re, Re, Gd, Gd, Gd, Gd, Gd, Gd
Gs, Re, Gs, Gs, Gs, Gg, Gg, Gg, Gg, Re, Gg, Gg, Gg, Gs, Gs, Gs, Gg, Gg, Gg, Gg, Gg, Gd^Dr, Re, Gd, Gd, Gd, Gd, Gd, Gd, Gd
Gs, Gs, Gs, Gs, Gs, Gg, Gg, Gg, Gg, Re, Gg, Gg, Gg, Gg, Gg, Gg, Gg, Gg, Gg, Gg, Gg, Gg, Re, Gd, Gd^Dr, Gd, Gd, Gd, Gg, Gg
Gs, Gs, Gs, Gs, Gg, Gg, Gg, Gg, Gg, Re, Gg, Gg, Gg, Gg, Gg, Gg, Gg, Gg, Gg, Gg, Gg, Gg, Re, Gg, Gg, Gd, Gg, Gg, Gg, Gg
Gg, Gg, Gg, Gg, Gg, Gg, Gg, Gg, Gg, Re, Gs, Gs, Gs, Gs, Gs, Gg, Gs, Gg, Gg, Gg, Gg, Gg, Re, Gg, Gg, Gg, Gg, Gg, Gg, Gg
Gg, Gg, Gg, Gg, Gg, Gg, Gg, Gg, Gs, Re, Gs, Gs, Gs, Gs, Gs, Gs, Gs, Gs, Gs, Gs, Gs, Re, Gs^Dr, Gs^Dr, Gs, Gg, Gg, Gg, Gg, Gg
Gg, Gg, Gg, Gg, Gs, Gs, Gs, Gs, Gs, Re, Gs, Gs, Gs, Gs, Gs, Gs, Gs, Gs, Gs, Gs, Re, Re, Gs, Gs, Gs, Gs, Gg, Gg, Gg, Gg
Gg, Gg, Gg, Gs, Gs, Gs, Gs, Gs, Re, Re, Re, Gs, Gs, Gs, Gs, Gs, Gs, Gs, Re, Re, Gs, Gs, Gs, Gs, Gs, Gg, Gg, Gg, Gg, Gg
Gg, Gg, Gs, Gs, Gs, Gs, Gs, Re, Gs, Gs, Re, Gs^Vc, Re, Gs, Gs, Gs, Re, Re, Gs, Gs, Gs, Gs, Gs, Gs, Gg, Gg, Gg, Gg, Gg, Gg
Gg, Gg, Gg, Gs, Gs, Gs, Gs, Re, Gs, Gs, Ce, Gs, Gs, Re, Re, Re, Gs, Gs, Gs, Gs, Gs, Gs, Gs, Gs, Gg, Gg, Gg, Gg, Gg, Gg
Gg, Gg, Gs, Gs, Gs, Gs, Gs, Re, Gs, Ce, 1 Ke, Ce, Gs, Gs, Re, Gs, Gs, Gs, Gs, Gs, Gs, Gs, Gs, Gg, Gg, Gg, Gg, Gg, Gg, Gg
Gg, Gg, Gs, Gs, Gs, Gs, Re, Re, Gs, Ce, Ce, Ce, Gs, Gs^Vc, Gs, Gs, Gs, Gs, Gs, Gs, Gs, Gs, Gg, Gg, Gg, Gg, Gg, Gg, Gg, Gg
Gg, Gg, Gs, Gs, Gs, Gs, Gs^Vc, Gs, Gs, Gs, Re, Gs, Re, Re, Gs, Gs, Gs, Gs, Gs, Gs, Gs, Gs, Gg, Gg, Gg, Gg, Gg, Gg, Gg, Gg
Gg, Gg, Gs, Gs, Gs, Gs, Gs, Re, Re, Gs, Re, Gs^Vc, Gs, Gs, Gs, Gs, Gs, Gs, Gs, Gs, Gs, Gs, Gg, Gg, Gg, Gg, Gg, Gg, Gg, Gg
Gg, Gg, Gs, Gs, Gs, Gs, Gs, Gs, Gs, Re, Gs, Gs, Gs, Gs, Gs, Gs, Gs, Gs, Gs, Gs, Gs, Gs, Gg, Gg, Gg, Gg, Gg, Gg, Gg, Gg
