border_size=1
usage=map

Gg, Gg, Gg, Gg, Gg, Gg, Gg, Gg, Gg, Gg, Xue, Xue, Uu, Uu, Uu, Uu, Uu, Uu, Uu, Uu, Uu, Uu, Uu, Uu, Uu, Uu, Uu, Uu, Uu^Uf, Uu, Uu, Uu, Uu, Uu, Uu, Uu, Uu, Uu, Uu, Uu, Uu, Uu, Uu, Uu, Uu, Uu, Uu, Xue, Iwr, Iwr, Iwr, Iwr
Xue, Gg, Gg, Gg, Gg, Gg, Gg, Gg, Xue, Xue, Uu, Uu, Uu, Uu, Uu, Uu, Uu, Uu, Uu, Uu, Uu, Uu, Uu, Uu, Uu, Uu, Uu, Uu^Uf, Uu^Uf, Uu^Uf, Uu, Uu, Uu^Uf, Uu^Uf, Uu^Uf, Uu, Uu, Uu, Uu, Uu, Uu, Uu, Uu, Uu, Uu, Uu, Uu, Xue, Iwr, Iwr, Iwr, Iwr
Uu^Ii, Xue, Xue, Gg, Gg, Gg, Xue, Xue, Uu, Uu, Uu, Uu, Uu, Uu, Uu, Uu, Uu, Uu, Uu, Uu, Uu, Uu, Uu, Uu^Vu, Uu, Uu, Uu, Uu^Uf, Uu^Uf, Uu^Uf, Uu^Cov, Uu, Uu^Uf, Uu^Uf, Uu^Uf, Uu^Uf, Uu, Uu, Uu, Uu, Uu^Emf, Uu, Uu, Uu, Uu, Uu, Uu, Xue, Iwr, Iwr, Iwr, Iwr
Uu^Ii, Uu^Ii, Uu^Ii, Xue, Xue, Xue, Uu, Uu, Uu, Uu, Uu, Uu, Uu, Uu, Uu, Uu, Uu, Uu, Uu, Uu, Uu, Uu, Uu, Ur, Ur, Uu, Uu, Uu, Ur, 3 Uu^Kov, Uu^Cov, Uu^Cov, Uu^Cov, Uu^Uf, Uu^Uf, Uu^Uf, Uu, Uu, Uu^Emf, Uu^Emf, Uu^Emf, Uu^Emf, Uu^Emf, Uu, Uu, Uu, Uu, Xue, Iwr, Iwr, Iwr, Iwr
Xue, Uu^Ii, Uu^Ii, Uu^Ii, Uu^Ii, Uu, Uu, Uu, Uu, Uu, Uu, Uu, Uu, Uu, Uu, Uu, Uu, Uu, Uu, Uu, Uu, Uu, Xu, Uu, Uu, Ur, Ur, Ur, Uu, Ur, Uu^Cov, Uu^Cov, Uu, Uu, Uu, Uu, Uu, Uu, Uu, Uu^Emf, Uu^Emf, Uu^Emf, Uu, Uu, Uu, Uu, Uu, Xue, Iwr, Iwr, Iwr, Iwr
Gg, Xue, Xue, Uu^Ii, Uu^Ii, Ur, Ur, Uu, Ur, Uu, Uu, Uu, Uu, Uu, Uu, Uu, Uu, Uu, Uu, Uu, Xu, Xu, Xu, Xu, Xu, Uu, Uu, Uu, Uu, Ur, Uu, Uu, Uu, Uu, Uu, Uu, Uu, Uu, Uu, Uu, Uu, Uu, Uu, Uu, Uu, Uu, Uu, Xue, Iwr, Iwr, Iwr, Iwr
Gg, Gg, Xue, Xue, Uu, Uu, Ur, Ur, Uu, Ur, Ur, Uu, Uu, Uu, Uu, Uu, Uu, Uu, Uu, Uu, Xu, Xu, Xu, Xu, Xu, Xu, Uu, Uu, Uu, Ur, Uu, Uu, Uu, Uu, Uu, Uu, Uu, Uu, Uu, Uu, Uu, Uu, Uu, Uu, Uu, Uu, Uu, Xue, Iwr, Iwr, Iwr, Iwr
Xue, Xue, Uu, Uu, Uu, Uu, Ur, Uu, Uu, Uu, Uu, Ur, Ur, Ur, Ur, Uu, Uu, Uu, Uu, Uu, Xu, Xu, Xu, Xu, Xu, Xu, Uu, Uu, Uu, Ur, Uu, Uu, Uu, Uu, Uu, Uu, Uu, Uu, Uu, Uu, Uh, Uh, Uh, Uu, Uu, Uu, Uu, Xue, Iwr, Iwr, Iwr, Iwr
Uu, Uu, Uu, Uu, Uu, Uu, Ur, Uu, Uu, Uu, Uu, Uu^Vu, Uu, Uu, Uu, Ur, Ur, Uu, Uu, Uu, Xu, Xu, Xu, Xu, Xu, Xu, Uu, Uu, Uu, Ur, Uu, Uu, Uu, Uu, Uu, Uu, Uu, Uu, Uu, Uh, Uh, Uh, Uh, Uh, Uu, Uu, Uu, Xue, Iwr, Iwr, Iwr, Iwr
Uu, Uu, Uu, Uu, Ur, Ur, Uu, Uu, Uu, Uu, Uu, Ur, Uu, Uu, Uu, Uu, Uu, Ur, Ur, Uu, Xu, Xu, Uu, Xu, Uu, Xu, Uu, Uu, Ur, Ur, Uu, Uu, Uu, Uu, Uu, Uu, Uu, Uu, Uu, Uh, Uh, Uh, Uh, Uh, Uu, Uu, Uu, Xue, Iwr, Iwr, Iwr, Iwr
Uu, Uu, Uu, Ur, Uu, Uu, Uu, Uu, Xu, Uu, Uu, Ur, Uu, Uu, Uu, Uu, Xu, Uu, Uu, Ur, Ur, Uu^Vu, Ur, Uu, Uu, Uu, Ur, Ur, Uu, Uu, Uu^Emf, Uu, Uu, Uu, Uu, Uu, Uu, Uu, Uu, Uu, Uu, Uh, Uh, Uh, Uu, Uu, Uu, Xue, Iwr, Iwr, Iwr, Iwr
Uu, Uu, Ur, Ur, Ur, Uu, Uu, Xu, Xu, Xu, Xu, Ur, Uu, Uu, Xu, Xu, Xu, Xu, Xu, Uu, Uu, Ur, Uu, Ur, Ur, Ur, Uu, Uu, Uu^Emf, Uu^Emf, Uu^Emf, Uu^Emf, Uu^Emf, Uu, Uu, Uu, Xu, Uu, Uu, Uu, Uu, Uu, Uu, Uu, Uu, Uu, Uu, Xue, Iwr, Iwr, Iwr, Iwr
Ur, Ur, Uu, Uu, Uu, Ur, Ur, Xu, Xu, Xu, Xu, Ur, Xu, Xu, Xu, Xu, Xu, Xu, Xu, Uu, Uu, Ur, Uu, Uu, Uu, Ur, Ur, Uu, Uu, Uu^Emf, Uu^Emf, Uu^Emf, Uu, Uu, Xu, Xu, Xu, Xu, Xu, Uu, Uu, Uu, Uu, Uu, Uu, Uu, Uu, Xue, Iwr, Iwr, Iwr, Iwr
Uu, Uu, Uu, Uu, Uu, Uu, Xu, Ur, Ur, Xu, Ur, Ur, Xu, Xu, Xu, Xu, Xu, Xu, Ur, Uu, Ur, Ur, Uu, Uu, Xu, Uu, Uu, Ur, Uu, Uu, Uu, Uu, Xu, Xu, Xu, Xu, Xu, Xu, Xu, Xu, Uu, Uu, Uu, Uu, Uu, Uu, Uu, Xue, Iwr, Iwr, Iwr, Iwr
Uu, Uu, Uu, Uu, Xu, Xu, Xu, Xu, Xu, Ur, Ur, Uu, Ur, Xu, Uu, Xu, Ur, Ur, Uu, Ur, Uu, Uu, Xu, Xu, Xu, Xu, Uu, Ur, Uu, Uu, Xu, Xu, Xu, Xu, Xu, Xu, Xu, Xu, Xu, Xu, Xu, Uu, Uu, Uu, Uu, Uu, Uu, Xue, Iwr, Iwr, Iwr, Iwr
Uu, Uu, Xu, Xu, Xu, Xu, Xu, Xu, Xu, Uu, Uu, Ur, Uu, Ur, Ur, Uu^Vu, Ur, Uu, Uu, Uu, Xu, Xu, Xu, Xu, Xu, Xu, Uu, Ur, Ur, Uu, Uu, Xu, Xu, Xu, Xu, Xu, Xu, Xu, Xu, Xu, Uue, Uue, Uu, Uu, Uu, Uu, Uu, Xue, Iwr, Iwr, Iwr, Iwr
Uu, Xu, Xu, Xu, Xu, Xu, Xu, Xu, Xu, Uu, Uu, Uu, Xu, Xu, Xu, Uu, Xu, Ur, Xu, Xu, Xu, Xu, Xu, Xu, Xu, Xu, Xu, Uu, Uu, Ur, Ur, Uu, Uu, Xu, Xu, Xu, Xu, Xu, Xu, Uue, Uue, Uue, Uue, Uu, Uu, Uu, Uu, Xue, Iwr, Iwr, Iwr, Iwr
Uue, Xu, Xu, Xu, Xu, Xu, Uu, Xu, Uu, Uu, Xu, Xu, Xu, Xu, Xu, Xu, Xu, Ur, Xu, Xu, Xu, Xu, Xu, Xu, Xu, Xu, Xu, Xu, Uu^Uf, Uu, Uu, Ur, Ur, Uu, Xu, Xu, Xu, Xu, Uue, Uu^Vu, Uue, Uue, Uue, Uu, Uu, Uu, Uu, Xue, Iwr, Iwr, Iwr, Iwr
Uue, Uue, Uue, Xu, Uu, Uu, Xu, Uu, Uu, Xu, Xu, Xu, Xu, Xu, Xu, Xu, Xu, Ur, Xu, Xu, Xu, Xu, Xu, Xu, Xu, Xu, Xu, Xu, Uu^Uf, Uu^Uf, Uu, Uu, Uu, Ur, Uu, Uue, Uue, Uue, Uh, Uh, Uh, Uue, Uu, Uu, Uu, Uu, Uu, Xue, Iwr, Iwr, Iwr, Iwr
Uue, Uue, Uue, Uue, Xu, Xu, Xu, Xu, Xu, Uu, Uu, Xu, Xu, Xu, Xu, Xu, Ur, Ur, Ur, Xu, Xu, Xu, Uue, Xu, Uue, Xu, Uu, Uu, Uu^Vu, Uu, Uu, Uu, Uu, Ur, Uu, Uu, Uu, Uue, Uu, Uh, Uu, Uu, Uu, Uu, Uu, Uu, Uu^Ii, Xue, Xue, Iwr, Iwr, Iwr
Uu, Uue, Xu, Xu, Xu, Xu, Xu, Xu, Xu, Xu, Xu, Uu, Uu, Xu, Ur, Ur, Xu, Uu, Uu, Ur, Ur, Uue, Uue, Uue, Uue, Uue, Uu, Uu, Uu, Uu, Uu, Uu, Ur, Ur, Ur, Uu, Uu, Uu, Uu, Uu, Uu, Uu, Uu, Uu, Uu, Uu, Uu^Ii, Uu^Ii, Uu^Ii, Xue, Xue, Iwr
Uu, Uu, Xu, Xu, Xu, Xu, Xu, Xu, Xu, Xu, Xu, Xu, Uu, Ur, Xu, Xu, Xu, Xu, Xu, Xu, Xu, Ur, Ur, Uu^Vu, Ur, Uu, Cud, Uu, Uu, Uu, Ur, Ur, Uu, Uu, Uu, Ur, Ur, Uu, Uu, Uu, Uu, Uu, Uu, Uu, Uu, Uu, Uu^Ii, Uu^Ii, Uu^Ii, Uu^Ii, Uu^Ii, Xue
Uue, Uue, Ur, Xu, Xu, Xu, Xu, Xu, Xu, Xu, Xu, Xu, Uu, Ur, Ur, Xu, Xu, Xu, Xu, Xu, Xu, Xu, Xu, Uu, Uu, Cud, 2 Kud, Cud, Ur, Ur, Uu, Uu, Uu, Uu, Uu, Uu, Uu, Ur, Ur, Uu, Uu, Uu, Uu, Uu, Ur, Ur, Uu^Ii, 1 Uu^Ii, Uu^Ii, Uu^Ii, Uu^Ii, Uu^Ii
Xu, Uue, Uu, Ur, Ur, Xu, Xu, Xu, Xu, Xu, Xu, Xu, Ur, Ur, Xu, Ur, Ur, Xu, Xu, Xu, Xu, Xu, Xu, Uu, Uu, Cud, Cud, Cud, Uu, Uu, Uu, Uu, Xu, Uu, Uh, Uh, Uu, Uu, Uu, Ur, Ur, Uu, Ur, Ur, Uu, Uu, Uu^Ii, Uu^Ii, Uu^Ii, Uu^Ii, Xue, Xue
Xu, Xu, Xu, Uu, Uu, Ur, Ur, Xu, Xu, Xu, Ur, Ur, Xu, Xu, Xu, Xu, Xu, Ur, Ur, Xu, Xu, Xu, Xu, Uu, Uu, Uu, Uu, Uu, Uu, Uu, Xu, Xu, Xu, Xu, Xu, Uh, Uu, Uu, Uu, Uu, Uu, Ur, Uu, Uu, Uu, Uu, Uu^Ii, Uu^Ii, Xue, Xue, Iwr, Iwr
Xu, Xu, Xu, Xu, Xu, Uu, Ur, Uu, Ur, Ur, Uu, Xu, Xu, Xu, Xu, Xu, Xu, Xu, Uue, Ur, Uu^Vu, Xu, Uu, Uu, Uu^Emf, Uu, Uu, Uu, Uu, Xu, Xu, Xu, Xu, Xu, Xu, Xu, Uu, Uu, Uu, Uu, Uu, Ur, Uu, Uu, Uu, Uu, Uu, Xue, Iwr, Iwr, Iwr, Iwr
Xu, Xu, Xu, Xu, Xu, Uu, Uu, Ur, Uu, Ur, Ur, Xu, Xu, Xu, Xu, Xu, Xu, Xu, Uue, Uue, Ur, Uu, Uu^Emf, Uu^Emf, Uu^Emf, Uu^Emf, Uu^Emf, Uu, Uu, Xu, Xu, Xu, Xu, Xu, Xu, Xu, Xu, Uue, Uue, Uu, Uu, Ur, Uu, Uu, Uh, Uu, Uu, Xue, Iwr, Iwr, Iwr, Iwr
Xu, Xu, Xu, Xu, Xu, Uu, Uu, Ur, Uu, Uu, Uu, Ur, Ur, Xu, Xu, Xu, Xu, Xu, Ur, Ur, Xu, Uu, Uu, Uu^Emf, Uu^Emf, Uu^Emf, Ur, Uu, Uu, Xu, Xu, Xu, Xu, Xu, Xu, Xu, Xu, Uue, Uue, Uue, Uu, Ur, Uu, Uh, Uu, Uu, Uu, Xue, Iwr, Iwr, Iwr, Iwr
Xu, Xu, Xu, Xu, Uue, Uu, Ur, Ur, Xu, Xu, Xu, Xu, Xu, Ur, Ur, Xu, Ur, Ur, Xu, Xu, Xu, Xu, Uu, Uu, Uu, Uu, Ur, Ur, Ur, Uue, Uue, Xu, Xu, Xu, Xu, Xu, Xu, Uue, Uue, Uue, Uu, Ur, Uu, Uu, Uu, Uu, Uu, Xue, Iwr, Iwr, Iwr, Iwr
Xu, Xu, Uue, Uue, Ur, Ur, Xu, Xu, Xu, Xu, Xu, Xu, Xu, Xu, Uu, Ur, Uu, Xu, Xu, Xu, Uu, Uu, Uu, Uu, Uu, Ur, Uu, Uu, Uu, Ur, Ur, Uue, Uue, Xu, Uue, Xu, Uh, Uh, Uh, Uu, Uu^Uf, Ur, Uu, Uu, Uu, Uu, Uu, Xue, Iwr, Iwr, Iwr, Iwr
Uue, Uue, Ur, Uu, Ur, Xu, Xu, Xu, Xu, Xu, Xu, Xu, Xu, Xu, Uu, Ur, Uu^Vu, Uu, Uu, Uu, Ur, Ur, Ur, Uu, Ur, Ur, Uu, Uu, Uu, Uu, Uu, Ur, Ur, Uue, Uue, Uh, Uh, Uh, Uh, Uu^Uf, Uu^Vu, Ur, Uu, Uu, Uu, Uu, Uu, Xue, Iwr, Iwr, Iwr, Iwr
Ur, Ur, Xu, Ur, Ur, Xu, Xu, Xu, Xu, Xu, Xu, Xu, Xu, Xu, Xu, Uu, Uu, Ur, Ur, Ur, Uu, Uu, Uu, Ur, Ur, Uu, Uu, Uu, Uu, Uu, Uu, Uu, Uu, Ur, Ur, Uh, Uh, Uh, Uh, Uu, Ur, Ur, Uu, Uu, Uu, Uu, Uu, Xue, Iwr, Iwr, Iwr, Iwr
Xu, Xu, Xu, Xu, Xu, Ur, Ur, Xu, Xu, Xu, Xu, Xu, Xu, Xu, Xu, Xu, Uu, Uu, Uu, Uu, Uu, Uu, Uu, Ur, Uu, Ur, Ur, Uu, Uu, Uu, Uu, Uu, Ur, Ur, Uu, Ur, Ur, Uu, Ur, Ur, Uu, Uu, Uu, Uu, Uu, Uu, Uu, Xue, Iwr, Iwr, Iwr, Iwr
Xu, Xu, Xu, Xu, Xu, Xu, Uu, Ur, Uu, Xu, Xu, Xu, Uu, Xu, Uu, Xu, Uu, Uu, Uu, Uu, Uu, Uu, Uu, Ur, Uu, Uu, Uu, Ur, Ur, Uu, Ur, Ur, Uu, Uu, Uu, Uu, Uu, Ur, Uu, Uu, Uh, Uh, Uh, Uu, Uu, Uu, Uu, Xue, Iwr, Iwr, Iwr, Iwr
Xu, Xu, Xu, Xu, Xu, Xu, Uu, Ur, Ur, Ur, Ur, Ur, Ur, Ur, Ur, Uu, Uu, Uu, Uu, Uu, Uu, Uu, Ur, Ur, Uu, Uu, Uu, Uu, Uu, Ur, Uu, Uu, Uu, Uu, Xu, Xu, Xu, Uu, Uu, Uu, Uh, Uh, Uh, Uh, Uh, Uu, Uu, Xue, Iwr, Iwr, Iwr, Iwr
Xu, Xu, Xu, Xu, Xu, Xu, Uu, Ur, Uu, Uu, Xu, Uu, Xu, Uu, Xu, Ur, Ur, Uu, Uu, Uu, Ur, Ur, Uu, Uu, Uu, Uu, Uu, Uu, Uu, Ur, Uu, Uu, Xu, Xu, Xu, Xu, Xu, Xu, Xu, Uu, Uh, Uh, Uh, Uh, Uh, Uu, Uu, Xue, Iwr, Iwr, Iwr, Iwr
Xu, Xu, Xu, Xu, Xu, Xu, Ur, Ur, Xu, Xu, Xu, Xu, Xu, Xu, Xu, Xu, Uu, Ur, Ur, Ur, Uu, Uu, Uu, Uu, Uu, Uu, Uu, Uu, Uu, Ur, Uu, Uu, Xu, Xu, Xu, Xu, Xu, Xu, Xu, Uu, Uu, Uh, Uh, Uh, Uu, Uu, Uu, Xue, Iwr, Iwr, Iwr, Iwr
Xu, Xu, Xu, Xu, Uue, Uue, Ur, Uu, Xu, Xu, Xu, Xu, Xu, Xu, Xu, Xu, Uu, Uu, Ur, Uu, Uu, Uu, Qxe, Uu, Qxe, Uu, Uu, Uu, Uu, Ur, Uu, Uu, Xu, Xu, Xu, Xu, Xu, Xu, Xu, Uu, Uu, Uu, Uu, Uu, Uu, Uu, Uu, Xue, Iwr, Iwr, Iwr, Iwr
Xu, Xu, Uue, Uue, Uue, Uue, Ur, Uue, Xu, Xu, Xu, Xu, Xu, Xu, Xu, Xu, Uue, Uu, Ur, Uue, Uue, Qxe, Qxe, Qxe, Qxe, Qxe, Uu, Uu, Ur, Ur, Uu, Uu, Xu, Xu, Xu, Xu, Xu, Xu, Xu, Uu, Uu, Uu, Uu, Uu, Uu, Uu, Uu, Xue, Iwr, Iwr, Iwr, Iwr
Uu, Ur, Ur, Uue, Uu, Ur, Uue, Uue, Uue, Xu, Ur, Xu, Xu, Xu, Uue, Uue, Uue, Uue, Ur, Uue, Uue, Qxe, Qxe, Qxe, Uu, Uu, Ur, Ur, Uu, Ur, Uu, Uu, Uu, Xu, Xu, Xu, Xu, Xu, Xu, Uu, Uu, Uu, Uu, Uu, Uu, Uu, Uu, Xue, Iwr, Iwr, Iwr, Iwr
Uu, Uu, Uu, Ur, Ur, Ur, Uu, Uue, Ur, Ur, Uu, Ur, Ur, Uu, Uu, Uue, Uue, Uue, Ur, Uue, Uue, Uue, Uue, Uu, Ur, Ur, Uu, Uu, Uu, Ur, Uu, Uu, Uu, Uu, Uu, Xu, Xu, Xu, Uu, Uu, Uu, Uu, Uu, Uu, Uu, Uu, Uu, Xue, Iwr, Iwr, Iwr, Iwr
Uu, Uu, Uu, Uu, Uu, Ur, Ur, Ur, Uu, Uu, Uu, Uu, Uu, Ur, Ur, Uu, Uu, Ur, Uu, Uue, Uue, Uue, Ur, Ur, Uu, Uu, Qxu, Uu, Uu, Ur, Uu, Uu, Xu, Xu, Xu, Uu, Uu, Uu, Xu, Uu, Uu, Uu, Uu, Uu, Uu, Uu, Uu, Xue, Iwr, Iwr, Iwr, Iwr
Uu, Uu, Uu, Uu, Xu, Uu, Xu, Xu, Xu, Xu, Xu, Uu, Xu, Uu, Uu, Ur, Ur, Ur, Uu, Uu, Ur, Ur, Uu, Uu, Uu, Qxu, Qxu, Qxu, Qxu, Ur, Xu, Xu, Xu, Xu, Xu, Xu, Xu, Xu, Xu, Uu, Uu, Uu, Uu, Uu, Uu, Uu, Uu, Xue, Iwr, Iwr, Iwr, Iwr
Uu, Uu, Uu, Xu, Xu, Xu, Xu, Xu, Xu, Xu, Xu, Xu, Xu, Xu, Xu, Uu, Uu, Ur, Ur, Ur, Uu, Uu, Uu, Uu, Uu, Qxu, Qxu, Qxu, Uu, Ur, Xu, Xu, Xu, Xu, Xu, Xu, Xu, Xu, Xu, Uu, Uu, Uu, Uu, Uu, Uu, Uu, Uu, Xue, Iwr, Iwr, Iwr, Iwr
Uu, Uu, Uu, Xu, Xu, Xu, Xu, Xu, Xu, Xu, Xu, Xu, Xu, Xu, Xu, Xu, Uu, Uu, Ur, Uu, Uu, Uu, Uu, Uu, Uu, Uu, Uu, Uu, Uu, Ur, Xu, Xu, Xu, Xu, Xu, Xu, Xu, Xu, Xu, Uu, Uu, Uu, Uu, Uu, Uu, Uu, Uu, Xue, Iwr, Iwr, Iwr, Iwr
Uh, Uh, Uh, Uu, Uu, Xu, Xu, Xu, Xu, Xu, Xu, Xu, Xu, Xu, Xu, Xu, Uu, Uu, Ur, Uu, Uu, Uu, Uu, Uu, Uu, Uu, Uu, Uu, Uu, Ur, Xu, Xu, Xu, Xu, Xu, Xu, Xu, Xu, Xu, Uu, Uu, Uu, Xu, Uu, Uu, Uu, Uu, Xue, Iwr, Iwr, Iwr, Iwr
Uh, Uh, Uh, Uh, Uh, Uu, Uu, Xu, Uu, Xu, Uu, Xu, Uu, Xu, Uu, Uu, Uu, Uu, Ur, Uu, Uu, Uu, Uu^Emf, Uu^Emf, Uu^Emf, Uu, Uu, Uu, Uu, Ur, Xu, Xu, Xu, Xu, Xu, Xu, Xu, Xu, Uu, Uu, Xu, Xu, Xu, Xu, Xu, Uu, Uu, Xue, Iwr, Iwr, Iwr, Iwr
Uh, Uh, Uh, Uh, Uh, Uh, Uu, Uu, Xu, Uu, Xu, Uu, Xu, Uu, Xu, Uu, Uu, Uu, Ur, Uu, Uu, Uu^Emf, Uu^Emf, Uu^Emf, Uu^Emf, Uu^Emf, Uu, Uu, Uu, Ur, Uu, Xu, Xu, Xu, Xu, Xu, Uu, Uu, Xu, Xu, Xu, Xu, Xu, Xu, Xu, Uu, Uu, Xue, Iwr, Iwr, Iwr, Iwr
Uh, Uh, Uh, Uh, Uu, Uu, Xu, Xu, Xu, Xu, Xu, Xu, Xu, Xu, Xu, Xu, Xu, Uu, Ur, Uu, Uu, Uu, Uu, Uu^Emf, Uu, Uu, Uu, Uu, Uu, Ur, Uu, Uu, Uu, Xu, Uu, Uu, Uu, Uu, Xu, Xu, Xu, Xu, Xu, Xu, Xu, Uu, Uu, Xue, Iwr, Iwr, Iwr, Iwr
Uh, Uh, Uh, Uh, Uu, Uu, Xu, Xu, Xu, Xu, Xu, Xu, Xu, Xu, Xu, Xu, Xu, Uu, Ur, Uu, Uu, Uu, Uu, Uu, Uu, Uu, Uu, Uu, Uu, Ur, Uu, Uu, Uu, Uu, Xu, Uu, Xu, Xu, Xu, Xu, Xu, Xu, Xu, Xu, Xu, Uu, Uu, Xue, Iwr, Iwr, Iwr, Iwr
Uu, Uu, Uu, Uu, Uu, Xu, Xu, Xu, Xu, Xu, Xu, Xu, Xu, Xu, Xu, Xu, Uu, Uu, Ur, Uu, Uu, Uu, Uu, Uu, Uu, Uu, Uu, Uu, Uu, Ur, Uu, Uu, Uu, Xu, Xu, Xu, Xu, Xu, Xu, Xu, Xu, Xu, Xu, Xu, Xu, Uu, Uu, Xue, Iwr, Iwr, Iwr, Iwr
Uu, Uu, Uu, Uu, Uu, Xu, Xu, Xu, Xu, Xu, Xu, Xu, Xu, Xu, Uu, Uu, Uu, Uu, Ur, Uu, Uu, Uu, Uu, Uu, Uu, Uu, Uu, Uu, Uu, Ur, Uu, Uu, Uu, Xu, Xu, Xu, Xu, Xu, Xu, Xu, Xu, Xu, Xu, Xu, Xu, Uu, Uu, Xue, Iwr, Iwr, Iwr, Iwr
