border_size=1
usage=map

Gg, Gg, Gg, Gg, Gg, Gg, Gg, Gg, Gg, Gg, Gg, Gg, Gg, Gg, Gg, Gg, Gg
Gg, Gg, Gg, Gg, Gg, Gg, Hh, Gg, Gg, Gg, Gg, Gg, Hh, Gg, Gg, Gg, Gg
Gg, Gg, Gg, Gg, Gg, Hh, Gg, Hh, Gg, Rr^Vhc, Gg, Hh, Gg, Hh, Gg, Gg, Gg
Gg, Gg, Hh, Gg, Rr^Vhc, Gg, Gg, Gg, Gg, Rr, Gg, Gg, Gg, Gg, Ch, Gg, Gg
Gg, Hh, Hh, Gg, Gg, Rr, Rr, Gg, Rr, Rr, Rr, Gg, Rr, Rr, Rr^Vhc, Ch, Gg
Gg, Gg, Gg, Hh, Gg, Gg, Gg, Rr, Gg, Gg, Gg, Rr, Gg, Gg, Ch, Ch, Gg
Gg, Gg, Gg, Gg, Gg, Gg, Gg, Rr, Gg, Gg, Rr, Rr, Gg, Gg, Gg, Gg, Gg
Rr, Gg, Gg, Gg, Gg, Gg, Rr, Rr, Rr, Gg, 2 Rr^Vhc, Gg, Gg, Gg, Gg, Gg, Gg
Gg, Rr, Rr, Gg, Rr, Rr, Gg, 1 Gg, Gg, Rr, Gg, Gg, Rr, Gg, Gg, Gg, Gg
Gg, Gg, Gg, Rr, Gg, Gg, Gg, Gg, Rr, Rr, Rr, Rr, Gg, Rr, Rr^Vhc, Gg, Gg
Gg, Gg, Gg, Gg, Gg, Gg, Rr, Rr, Gg, Gg, Rr^Vhc, Gg, Gg, Gg, Gs^Fds, Gs^Fds, Gs^Fds
Gg, Gg, Gg, Gg, Gg, Rr^Vhc, Gg, Gg, Gg, Gg, Gg, Gg, Gg, Gs^Fds, Gs^Fds, Gs^Fds, Gs^Fds
Gg, Gg, Gs^Fds, Gs^Fds, Gs^Fds, Gg, Gs^Fds, Gg, Gg, Gg, Gg, Gg, Gg, Gs^Fds, Gs^Fds, Gs^Fds, Gs^Fds
Gs^Fds, Gs^Fds, Gs^Fds, Gs^Fds, Gs^Fds, Gs^Fds, Gs^Fds, Gg, Gg, Ch, Ch, Ch, Gg, Gs^Fds, Gs^Fds, Gs^Fds, Gs^Fds
Gs^Fds, Gs^Fds, Gs^Fds, Gs^Fds, Gs^Fds, Gs^Fds, Gs^Fds, Gg, Gg, Gg, Gg, Gg, Gg, Gg, Gg, Gs^Fds, Gg
Gg, Gs^Fds, Gs^Fds, Gs^Fds, Gs^Fds, Gs^Fds, Gg, Gg, Gg, Gg, Gg, Gg, Gg, Gg, Gg, Gg, Gg
Gg, Gg, Gg, Gg, Gg, Gg, Gg, Gg, Gg, Gg, Gg, Gg, Gg, Gg, Gg, Gg, Gg
