border_size=1
usage=map

Iwr, Iwr, Iwr, Iwr, Iwr, Iwr, Iwr, Xos, Iwr, Iwr, Iwr, Iwr, Iwr, Iwr, Iwr, Iwr, Iwr
Iwr, Iwr, Iwr, Iwr, Iwr, Iwr, Iwr, Xos, Iwr, Iwr, Iwr, Iwr, Ch, Iwr, Iwr, Iwr, Iwr
Iwr, Iwr, Iwr, Iwr, Iwr, Iwr, Iwr, Xos, Iwr, Iwr, Iwr, Ch, Kh, Ch, Iwr, Iwr, Iwr
Iwr, Iwr, Xos, Iwr, Iwr, Iwr, Iwr, Xos, Xos, Iwr, Iwr, Ch, Ch, Ch, Iwr, 2 Iwr, Iwr
Xos, Xos, Xos, Xos, Xos, Iwr, Iwr, Xos^Efs, Xos^Efs, Xos, Xos, Iwr, Iwr, Iwr, Iwr, Iwr, Iwr
Xos, Xos, Xos, Xos, Xos, Xos, Xos, Iwr, Iwr, Xos^Efs, Iwr, Iwr, Iwr, Iwr, Iwr, Iwr, Xos
Iwr, Iwr, Iwr, Iwr, Xos, Xos, Xos, Xos, Iwr, Iwr, Iwr, Iwr, Xos, Iwr, Xos^Efs, Xos^Efs, Iwr
Iwr, Iwr, Iwr, Iwr, Xos, Xos, Xos^Efs, Xos^Efs, Iwr, Iwr, Xos, Xos, Xos^Efs, Xos^Efs, Iwr, Iwr, Iwr
Xos, Iwr, Xos, Iwr, Iwr, Xos^Efs, Iwr, Iwr, Iwr, Iwr, Xos, Xos^Efs, Iwr, Iwr, Iwr, Iwr, Xos
Xos, Xos, Iwr, Xos^Efs, Xos^Efs, Iwr, Iwr, Iwr, Iwr, Iwr, Iwr, Iwr, Iwr, Iwr, Xos, Xos, Xos
Iwr, Iwr, Iwr, Iwr, Iwr, Iwr, Iwr, Iwr, Iwr, Iwr, Iwr, Iwr, Xos, Xos, Xos, Xos, Xos^Efs
Xos, Iwr, Iwr, Iwr, Xos, Iwr, Iwr, Iwr, Iwr, Iwr, Iwr, Iwr, Xos, Xos, Xos^Efs, Xos^Efs, Iwr
Iwr, Xos^Efs, Xos^Efs, Xos, Xos, Xos, Iwr, Iwr, Iwr, Iwr, Iwr, Iwr, Iwr, Xos^Efs, Iwr, Iwr, Iwr
Iwr, Iwr, Iwr, Xos^Efs, Xos^Efs, Xos, Iwr, Iwr, Iwr, Iwr, Iwr, Iwr, Iwr, Iwr, Iwr, Iwr, Xos^Efs
Iwr, Iwr, Iwr, Iwr, Iwr, Xos, Iwr, Iwr, Iwr, Iwr, Xos, Iwr, Xos, Xos, Xos^Efs, Xos^Efs, Iwr
Xos, Iwr, Iwr, Iwr, Iwr, Xos, Iwr, Iwr, Iwr, Xos, Xos, Xos, Xos^Efs, Xos^Efs, Iwr, Iwr, Iwr
Gg, Xos, Xos, Iwr, Iwr, Iwr, Iwr, Iwr, Iwr, Iwr, Iwr, Xos^Efs, Iwr, Iwr, Iwr, Iwr, Xos
Gg, Gg, Gg, Xos, Xos, Iwr, Iwr, Iwr, Iwr, Iwr, Iwr, Iwr, Iwr, Iwr, Xos, Xos, Gg
Gg, Gg, Gg, Gg, Gg, Xos, Xos, Iwr, Iwr, 1 Iwr, Iwr, Iwr, Xos, Xos, Gg, Gg, Gg
Gg, Gg, Gg, Gg, Gg, Gg, Gg, Xos, Iwr, Iwr, Iwr, Xos, Gg, Gg, Gg, Gg, Gg
Gg, Gg, Gg, Gg, Gg, Gg, Gg, Xos, Iwr, Iwr, Iwr, Xos, Gg, Gg, Gg, Gg, Gg
Gg, Gg, Gg, Gg, Gg, Gg, Gg, Xos, Iwr, Iwr, Iwr, Xos, Gg, Gg, Gg, Gg, Gg
