border_size=1
usage=map

Iwr, Iwr, Iwr, Iwr, Iwr, Iwr, Iwr, Xos, Iwr, Iwr, Iwr, Iwr, Iwr, Iwr, Iwr, Iwr, Iwr
Iwr, Iwr, Iwr, Iwr, Iwr, Iwr, Iwr, Xos, Iwr, Iwr, Iwr, Iwr, Ch, Iwr, Iwr, Iwr, Iwr
Iwr, Iwr, Iwr, Iwr, Iwr, Iwr, Iwr, Xos, Iwr, Iwr, Iwr, Ch, Kh, Ch, Iwr, Iwr, Iwr
Iwr, Iwr, Xos, Iwr, Iwr, Iwr, Iwr, Xos, Xos, Iwr, Iwr, Ch, Ch, Ch, Iwr, 2 Iwr, Iwr
Xos, Xos, Xos, Xos, Xos, Iwr, Iwr, Xol, Xol, Xos, Xos, Iwr, Iwr, Iwr, Iwr, Iwr, Iwr
Xos, Xos, Xos, Xos, Xos, Xos, Xos, Iwr, Iwr, Xol, Iwr, Iwr, Iwr, Iwr, Iwr, Iwr, Xos
Iwr, Iwr, Iwr, Iwr, Xos, Xos, Xos, Xos, Iwr, Iwr, Iwr, Iwr, Xos, Iwr, Xol, Xol, Iwr
Iwr, Iwr, Iwr, Iwr, Xos, Xos, Xol, Xol, Iwr, Iwr, Xos, Xos, Xol, Xol, Iwr, Iwr, Iwr
Xos, Iwr, Xos, Iwr, Iwr, Xol, Iwr, Iwr, Iwr, Iwr, Xos, Xol, Iwr, Iwr, Iwr, Iwr, Xos
Xos, Xos, Iwr, Xol, Xol, Iwr, Iwr, Iwr, Iwr, Iwr, Iwr, Iwr, Iwr, Iwr, Xos, Xos, Xos
Iwr, Iwr, Iwr, Iwr, Iwr, Iwr, Iwr, Iwr, Iwr, Iwr, Iwr, Iwr, Xos, Xos, Xos, Xos, Xol
Xos, Iwr, Iwr, Iwr, Xos, Iwr, Iwr, Iwr, Iwr, Iwr, Iwr, Iwr, Xos, Xos, Xol, Xol, Iwr
Iwr, Xol, Xol, Xos, Xos, Xos, Iwr, Iwr, Iwr, Iwr, Iwr, Iwr, Iwr, Xol, Iwr, Iwr, Iwr
Iwr, Iwr, Iwr, Xol, Xol, Xos, Iwr, Iwr, Iwr, Iwr, Iwr, Iwr, Iwr, Iwr, Iwr, Iwr, Xol
Iwr, Iwr, Iwr, Iwr, Iwr, Xos, Iwr, Iwr, Iwr, Iwr, Xos, Iwr, Xos, Xos, Xol, Xol, Iwr
Xos, Iwr, Iwr, Iwr, Iwr, Xos, Iwr, Iwr, Iwr, Xos, Xos, Xos, Xol, Xol, Iwr, Iwr, Iwr
Gg, Xos, Xos, Iwr, Iwr, Iwr, Iwr, Iwr, Iwr, Iwr, Iwr, Xol, Iwr, Iwr, Iwr, Iwr, Xos
Gg, Gg, Gg, Xos, Xos, Iwr, Iwr, Iwr, Iwr, Iwr, Iwr, Iwr, Iwr, Iwr, Xos, Xos, Gg
Gg, Gg, Gg, Gg, Gg, Xos, Xos, Iwr, Iwr, 1 Iwr, Iwr, Iwr, Xos, Xos, Gg, Gg, Gg
Gg, Gg, Gg, Gg, Gg, Gg, Gg, Xos, Iwr, Iwr, Iwr, Xos, Gg, Gg, Gg, Gg, Gg
Gg, Gg, Gg, Gg, Gg, Gg, Gg, Xos, Iwr, Iwr, Iwr, Xos, Gg, Gg, Gg, Gg, Gg
Gg, Gg, Gg, Gg, Gg, Gg, Gg, Xos, Iwr, Iwr, Iwr, Xos, Gg, Gg, Gg, Gg, Gg
