border_size=1
usage=map

Iwr^_fme, Iwr^_fme, Iwr^_fme, Iwr^_fme, Iwr^_fme, Iwr^_fme, Iwr^_fme, Iwr, Iwr, Iwr, Iwr, Iwr, Xos, Xos, Xos, Xos, Xos^Efs, Xos, Xos^Efs, Xos, Xos, Xos, Xos, Xos, Xos, Xos, Xos, Iwr, Iwr, Iwr, Iwr, Iwr, Iwr, Iwr, Iwr, Iwr, Iwr, Xos, Xos, Xos, Xos, Xos, Xos, Iwr, Iwr, Iwr, Iwr, Iwr, Iwr, Xos, Gg, Gg
Iwr^_fme, Iwr^_fme, Iwr^_fme, Iwr^_fme, Iwr^_fme, Iwr^_fme, Iwr^_fme, Iwr, Iwr, Iwr, Iwr, Iwr, Xos, Xos, Xos, Xos^Efs, Iwr, Iwr, Iwr, Xos^Efs, Xos, Xos, Xos, Xos, Xos, Xos, Xos, Iwr, Iwr, Iwr, Iwr, Iwr, Iwr, Iwr, Iwr, Iwr, Iwr, Xos, Xos, Xos, Xos, Xos, Xos, Iwr, Iwr, Iwr, Iwr, Iwr, Iwr, Xos, Gg, Gg
Iwr^_fme, Iwr^_fme, Iwr^_fme, Iwr^_fme, Iwr^_fme, Iwr^_fme, Iwr^_fme, Iwr, Iwr, Iwr, Iwr, Iwr, Xos, Xos, Xos, Xos, Iwr, Iwr, Iwr, Iwr, Xos, Xos, Xos, Xos, Xos, Xos, Xos, Iwr, Iwr, Iwr, Iwr, Iwr, Iwr, Iwr, Iwr, Iwr, Iwr, Xos, Xos, Xos, Xos, Xos, Xos, Iwr, Iwr, Iwr, Iwr, Iwr, Iwr, Xos, Gg, Gg
Iwr^_fme, Iwr^_fme, Iwr^_fme, Iwr^_fme, Iwr^_fme, Iwr^_fme, Iwr^_fme, Iwr, Iwr, Iwr, Iwr, Iwr, Xos, Xos, Xos, Xos, Xos, Iwr, Iwr, Iwr, Xos, Xos, Xos, Xos, Xos, Xos, Xos, Iwr, Iwr, Iwr, Iwr, Iwr, Iwr, Iwr, Iwr, Iwr, Iwr, Xos, Xos, Xos, Xos, Xos, Xos, Iwr, Iwr, Iwr, Iwr, Iwr, Iwr, Xos, Gg, Gg
Iwr^_fme, Iwr^_fme, Iwr^_fme, Iwr^_fme, Iwr^_fme, Iwr^_fme, Iwr^_fme, Iwr, Iwr, Iwr, Iwr, Iwr, Xos, Xos, Xos, Xos, Xos, Iwr, Iwr, Iwr, Xos, Xos, Xos, Xos, Xos, Xos, Xos, Iwr, Iwr, Iwr, Iwr, Iwr, Iwr, Iwr, Iwr, Iwr, Iwr, Xos, Xos, Xos, Xos, Xos, Xos, Iwr, Iwr, Iwr, Iwr, Iwr, Iwr, Xos, Gg, Gg
Iwr^_fme, Iwr^_fme, Iwr^_fme, Iwr^_fme, Iwr^_fme, Iwr^_fme, Iwr^_fme, Iwr, Iwr, Iwr, Iwr, Iwr, Xos, Xos, Xos, Xos, Xos, Iwr, Iwr, Iwr, Xos, Xos, Xos, Xos, Xos, Xos, Iwr, Iwr, Iwr, Iwr, Iwr, Iwr, Iwr, Iwr, Iwr, Iwr, Iwr, Xos, Xos, Xos, Xos, Xos, Xos, Iwr, Iwr, Iwr, Iwr, Iwr, Iwr, Xos, Gg, Gg
Iwr^_fme, Iwr^_fme, Iwr^_fme, Iwr^_fme, Iwr^_fme, Iwr^_fme, Iwr^_fme, Iwr, Iwr, Iwr, Iwr, Iwr, Xos^Efs, Xos, Xos, Xos, Xos^Efs, Iwr, Iwr, Iwr, Xos, Xos, Xos, Xos, Xos, Xos, Iwr, Iwr, Iwr, Iwr, Iwr, Iwr, Iwr, Iwr, Iwr, Iwr, Iwr, Xos, Xos, Xos, Xos, Xos, Xos, Iwr, Iwr, Iwr, Iwr, Iwr, Iwr, Xos, Gg, Gg
Iwr^_fme, Iwr^_fme, Iwr^_fme, Iwr^_fme, Iwr^_fme, Iwr^_fme, Iwr^_fme, Iwr, Iwr, Iwr, Iwr, Iwr, Iwr, Xos^Efs, Xos^Efs, Xos^Efs, Iwr, Iwr, Xos, Xos, Xos, Xos, Xos, Xos, Xos, Xos, Iwr, Iwr, Iwr, Iwr, Iwr, Iwr, Iwr, Iwr, Iwr, Iwr, Iwr, Xos^Efs, Xos^Efs, Xos, Xos, Xos, Xos^Efs, Iwr, Iwr, Iwr, Iwr, Iwr, Iwr, Xos, Gg, Gg
Iwr^_fme, Iwr^_fme, Iwr^_fme, Iwr^_fme, Iwr^_fme, Iwr^_fme, Iwr^_fme, Iwr, Iwr, Iwr, Iwr, Iwr, Iwr, Iwr, Iwr, Iwr, Iwr, Xos, Xos, Xos, Xos, Xos, Xos, Xos, Xos^Efs, Xos^Efs, Iwr, Iwr, Iwr, Iwr, Iwr, Iwr, Iwr, Iwr, Iwr, Iwr, Iwr, Iwr, Iwr, Xos^Efs, Xos^Efs, Xos^Efs, Iwr, Iwr, Iwr, Iwr, Iwr, Iwr, Iwr, Xos, Gg, Gg
Iwr^_fme, Iwr^_fme, Iwr^_fme, Iwr^_fme, Iwr^_fme, Iwr^_fme, Iwr^_fme, Iwr, Iwr, Iwr, Iwr, Iwr, Iwr, Iwr, Iwr, Iwr, Iwr, Xos^Efs, Xos^Efs, Xos, Iwr, Xos, Xos, Iwr, Iwr, Iwr, Iwr, Iwr, Iwr, Iwr, Iwr, Iwr, Iwr, Iwr, Iwr, Iwr, Iwr, Iwr, Iwr, Iwr, Iwr, Iwr, Iwr, Iwr, Iwr, Iwr, Iwr, Iwr, Iwr, Xos, Gg, Gg
Iwr^_fme, Iwr^_fme, Iwr^_fme, Iwr^_fme, Iwr^_fme, Iwr^_fme, Iwr^_fme, Iwr, Iwr, Iwr, Iwr, Iwr, Iwr, Iwr, Iwr, Iwr, Iwr, Iwr, Iwr, Iwr, Iwr, Iwr, Xos, Xos, Xos, Xos, Xos, Iwr, Iwr, Iwr, Iwr, Iwr, Iwr, Iwr, Iwr, Iwr, Iwr, Iwr, Xos, Xos, Xos, Iwr, Iwr, Iwr, Iwr, Iwr, Iwr, Iwr, Iwr, Xos, Gg, Gg
Iwr^_fme, Iwr^_fme, Iwr^_fme, Iwr^_fme, Iwr^_fme, Iwr^_fme, Iwr^_fme, Iwr, Iwr, Iwr, Iwr, Iwr, Iwr, Iwr, Iwr, Iwr, Iwr, Iwr, Iwr, Iwr, Iwr, Iwr, Xos, Xos, Xos, Xos, Xos, Xos, Iwr, Iwr, Iwr, Iwr, Iwr, Iwr, Iwr, Iwr, Iwr, Xos, Xos, Xos, Xos, Xos, Xos, Iwr, Iwr, Iwr, Iwr, Iwr, Iwr, Xos, Gg, Gg
Iwr^_fme, Iwr^_fme, Iwr^_fme, Iwr^_fme, Iwr^_fme, Iwr^_fme, Iwr^_fme, Iwr, Iwr, Iwr, Iwr, Iwr, Iwr, Iwr, Iwr, Iwr, Iwr, Iwr, Iwr, Iwr, Iwr, Iwr, Xos, Xos, Xos, Xos, Xos, Xos, Iwr, Iwr, Iwr, Iwr, Iwr, Iwr, Iwr, Iwr, Iwr, Xos, Xos, Xos, Xos, Xos, Xos^Efs, Iwr, Iwr, Iwr, Iwr, Iwr, Iwr, Xos, Gg, Gg
Iwr^_fme, Iwr^_fme, Iwr^_fme, Iwr^_fme, Iwr^_fme, Iwr^_fme, Iwr^_fme, Iwr, Iwr, Iwr, Iwr, Iwr, Iwr, Iwr, Iwr, Iwr, Iwr, Iwr, Iwr, Iwr, Iwr, Iwr, Xos, Xos, Xos, Xos, Xos, Xos, Iwr, Iwr, Iwr, Iwr, Iwr, Iwr, Iwr, Iwr, Iwr, Xos, Xos, Xos, Xos^Efs, Xos^Efs, Iwr, Iwr, Iwr, Iwr, Iwr, Iwr, Iwr, Xos, Gg, Gg
Iwr^_fme, Iwr^_fme, Iwr^_fme, Iwr^_fme, Iwr^_fme, Iwr^_fme, Iwr^_fme, Iwr, Iwr, Iwr, Iwr, Iwr, Iwr, Iwr, Iwr, Iwr, Iwr, Iwr, Iwr, Iwr, Iwr, Iwr, Xos, Xos, Xos, Xos, Xos, Xos, Iwr, Iwr, Iwr, Iwr, Iwr, Iwr, Iwr, Iwr, Iwr, Xos^Efs, Xos^Efs, Xos^Efs, Iwr, Iwr, Iwr, Iwr, Iwr, Iwr, Iwr, Iwr, Iwr, Xos, Gg, Gg
Iwr^_fme, Iwr^_fme, Iwr^_fme, Iwr^_fme, Iwr^_fme, Iwr^_fme, Iwr^_fme, Iwr, Iwr, Iwr, Iwr, Iwr, Iwr, Iwr, Iwr, Iwr, Iwr, Iwr, Iwr, Iwr, Iwr, Xos, Xos, Xos, Xos, Xos, Xos, Xos, Iwr, Iwr, Iwr, Iwr, Iwr, Iwr, Iwr, Iwr, Iwr, Iwr, Iwr, Iwr, Xos, Iwr, Iwr, Iwr, Iwr, Iwr, Iwr, Iwr, Iwr, Xos, Gg, Gg
Iwr^_fme, Iwr^_fme, Iwr^_fme, Iwr^_fme, Iwr^_fme, Iwr^_fme, Iwr^_fme, Iwr, Iwr, Iwr, Iwr, Iwr, Iwr, Iwr, Iwr, Iwr, Iwr, Iwr, Iwr, Iwr, Iwr, Xos, Xos, Xos, Xos, Xos, Xos, Xos, Iwr, Iwr, Iwr, Iwr, Iwr, Iwr, Xos, Xos, Xos, Iwr, Xos, Xos, Xos, Xos, Xos, Iwr, Iwr, Iwr, Iwr, Iwr, Iwr, Xos, Gg, Gg
Iwr^_fme, Iwr^_fme, Iwr^_fme, Iwr^_fme, Iwr^_fme, Iwr^_fme, Iwr^_fme, Iwr, Iwr, Iwr, Iwr, Iwr, Iwr, Iwr, Iwr, Iwr, Iwr, Iwr, Iwr, Iwr, Iwr, Xos, Iwr, Xos, Xos, Xos, Xos^Efs, Xos^Efs, Iwr, Iwr, Iwr, Iwr, Iwr, Xos, Xos, Xos, Xos, Xos, Xos, Xos, Xos, Xos, Xos, Iwr, Iwr, Iwr, Iwr, Iwr, Iwr, Xos, Gg, Gg
Iwr^_fme, Iwr^_fme, Iwr^_fme, Iwr^_fme, Iwr^_fme, Iwr^_fme, Iwr^_fme, Iwr, Iwr, Iwr, Iwr, Iwr, Iwr, Iwr, Iwr, Iwr, Iwr, Iwr, Iwr, Iwr, Iwr, Xos, Iwr, Xos^Efs, Xos^Efs, Xos^Efs, Iwr, Iwr, Iwr, Iwr, Iwr, Iwr, Iwr, Xos, Xos, Xos, Xos, Xos, Xos, Xos, Xos, Xos, Xos, Iwr, Iwr, Iwr, Iwr, Iwr, Iwr, Xos^Efs, Xos^Efs, Gg
Iwr^_fme, Iwr^_fme, Iwr^_fme, Iwr^_fme, Iwr^_fme, Iwr^_fme, Iwr^_fme, Iwr, Iwr, Iwr, Iwr, Iwr, Iwr, Iwr, Iwr, Iwr, Iwr, Iwr, Iwr, Iwr, Iwr, Xos, Iwr, Iwr, Iwr, Iwr, Xos, Iwr, Iwr, Iwr, Iwr, Iwr, Xos, Xos, Xos, Xos, Xos, Xos, Xos, Xos, Xos, Xos, Xos, Iwr, Iwr, Iwr, Iwr, Iwr, Iwr, Iwr, Iwr, Xos^Efs
Iwr^_fme, Iwr^_fme, Iwr^_fme, Iwr^_fme, Iwr^_fme, Iwr^_fme, Iwr^_fme, Iwr, Iwr, Iwr, Iwr, Iwr, Iwr, Iwr, Iwr, Iwr, Iwr, Iwr, Iwr, Iwr, Iwr, Xos, Xos, Xos, Xos, Xos, Xos, Xos, Xos, Iwr, Iwr, Iwr, Xos, Xos, Xos, Xos, Xos, Xos, Xos, Xos, Xos, Xos, Xos, Iwr, Iwr, Iwr, Iwr, Iwr, 1 Iwr, Iwr, Iwr, Iwr
Iwr^_fme, Iwr^_fme, Iwr^_fme, Iwr^_fme, Iwr^_fme, Iwr^_fme, Iwr^_fme, Iwr, Ch, Iwr, Iwr, Iwr, Iwr, Iwr, Iwr, Iwr, Iwr, Iwr, Iwr, Iwr, Iwr, Xos, Xos, Xos, Xos, Xos, Xos, Xos, Xos, Xos, Iwr, Iwr, Xos, Xos, Xos, Xos, Xos, Xos, Xos, Xos, Xos, Xos, Xos, Iwr, Iwr, Iwr, Iwr, Iwr, Iwr, Iwr, Iwr, Iwr
Iwr^_fme, Iwr^_fme, Iwr^_fme, Iwr^_fme, Iwr^_fme, Iwr^_fme, Iwr^_fme, Ch, 2 Kh, Ch, Iwr, Iwr, Iwr, Iwr, Iwr, Iwr, Iwr, Iwr, Iwr, Iwr, Iwr, Xos, Xos, Xos, Xos, Xos, Xos, Xos, Xos, Xos, Iwr, Iwr, Xos, Xos, Xos, Xos, Xos, Xos, Xos, Xos, Xos, Xos, Xos, Iwr, Iwr, Iwr, Iwr, Iwr, Iwr, Iwr, Xos, Xos
Iwr^_fme, Iwr^_fme, Iwr^_fme, Iwr^_fme, Iwr^_fme, Iwr^_fme, Iwr^_fme, Ch, Ch, Ch, Iwr, Iwr, Iwr, Iwr, Iwr, Iwr, Iwr, Iwr, Iwr, Iwr, Iwr, Xos, Xos, Xos, Xos, Xos, Xos, Xos, Xos^Efs, Xos^Efs, Iwr, Iwr, Xos, Xos, Xos, Xos, Xos, Xos, Xos, Xos, Xos, Xos, Xos, Iwr, Iwr, Iwr, Iwr, Iwr, Xos, Xos, Gg, Gg
Iwr^_fme, Iwr^_fme, Iwr^_fme, Iwr^_fme, Iwr^_fme, Iwr^_fme, Iwr^_fme, Iwr, Iwr, Iwr, Iwr, Iwr, Iwr, Iwr, Iwr, Iwr, Iwr, Iwr, Iwr, Iwr, Iwr, Xos, Xos, Xos, Xos^Efs, Xos, Xos^Efs, Xos^Efs, Iwr, Iwr, Iwr, Iwr, Xos, Xos, Xos, Xos, Xos, Xos, Xos, Xos, Xos, Xos, Xos, Iwr, Iwr, Iwr, Xos, Xos, Gg, Gg, Gg, Gg
Iwr^_fme, Iwr^_fme, Iwr^_fme, Iwr^_fme, Iwr^_fme, Iwr^_fme, Iwr^_fme, Iwr, Iwr, Iwr, Iwr, Iwr, Iwr, Iwr, Iwr, Iwr, Iwr, Iwr, Iwr, Iwr, Iwr, Iwr^Xo, Iwr, Iwr, Iwr, Iwr, Iwr, Iwr, Iwr, Iwr, Iwr, Iwr, Xos, Xos, Xos, Xos, Xos, Xos, Xos, Xos, Xos, Xos, Xos, Iwr, Iwr, Xos, Gg, Gg, Gg, Gg, Gg, Gg
Iwr^_fme, Iwr^_fme, Iwr^_fme, Iwr^_fme, Iwr^_fme, Iwr^_fme, Iwr^_fme, Iwr, Iwr, Iwr, Iwr, Iwr, Iwr, Iwr, Iwr, Iwr, Iwr, Iwr, Iwr, Iwr, Iwr, Iwr^Xo, Iwr, Iwr, Iwr, Iwr, Iwr, Iwr, Iwr, Iwr, Iwr, Iwr, Xos, Xos, Xos, Xos, Xos, Xos, Xos, Xos, Xos, Xos, Xos, Xos, Xos, Xos, Gg, Gg, Gg, Gg, Gg, Gg
