border_size=1
usage=map

Gg, Gg, Gg, Gd, Gd, Gd, Gd, Gd, Gd^Em, Gd, Gd, Gd, Gd, Gd, Gd, Gd, Gd, Gd, Gd, Gd, Gd, Gd, Gd, Hh^Fp, Hh^Fp, Hh^Fp, Hh^Fp, Hh^Fp, Hh^Fp, Hh^Fp, Hh^Fp, Hh^Fp, Hh, Hh, Hh, Mm, Mm, Mm, Mm, Mm, Mm, Mm, Hh, Hh, Hh^Fds, Hh^Fds, Hh^Fds, Hh^Fds, Hh^Fds, Hh^Fds, Hh^Fds, Hh^Fds, Hh^Fds, Gg, Gg, Gg, Gg, Gg, Gg, Gg, Gg, Gg
Gg, Gg, Gg, Gd, Gd, Gd, Gd, Gd, Gd^Em, Gd^Em, Gd, Gd, Gd, Gd^Em, Gd, Gd, Gd, Gd, Gd, Gd, Gd^Emf, Gd, Gd, Hh^Fp, Hh^Fp, Hh^Fp, Hh^Fp, Hh^Fp, Hh^Fp, Hh^Fp, Hh^Fp, Hh, Hh, Hh, Hh, Mm, Mm, Mm, Mm, Mm, Mm, Mm, Hh, Hh, Hh^Fds, Hh^Fds, Hh^Fds, Hh^Fds, Hh^Fds, Hh^Fds, Hh^Fds, Hh^Fds, Hh^Fds, Hh^Fds, Gg, Gg, Gg, Gg, Gg^Em, Gg^Em, Gg^Em, Gg
Gg, Gg, Gg, Gd, Gd, Gd, Gd, Gd, Gd, Gd^Em, Gd, Gd, Gd^Em, Gd, Gd, Gd, Gd, Gd, Gd^Emf, Gd^Emf, Gd^Emf, Gd^Emf, Hh, Hh, Hh, Hh^Fp, Hh^Fp, Hh^Fp, Hh^Fp, Hh^Fp, Hh^Fp, Hh^Fp, Hh, Hh, Hh, Mm, Mm, Mm, Mm, Mm, Mm, Mm, Hh, Hh, Hh^Fds, Hh^Fds, Hh^Fds, Hh^Fds, Hh^Fds, Hh^Fds, Hh^Fds, Hh^Fds, Hh^Fds, Hh^Fds, Gg, Gg, Gg, Gg, Gg, Gg^Em, Gg, Gg
Gg, Gg, Gg, Gd, Gd^Em, Gd^Em, Gd^Em, Gd, Gd, Gd, Gd, Gd, Gd, Gd, Gd, Gd^Em, Gd, Gd, Gd, Gd^Emf, Hh, Hh, Hh, Hh, Hh, Hh, Gg, Hh^Fp, Gg, Gg, Gg, Gd, Gd^Em, Hh, Hh, Hh, Hh, Mm, Mm, Mm, Hh, Hh, Hh, Hh, Gd, Gs, Gs, Hh^Fds, Gs, Gs, Gs, Hh^Fds, Gs, Gg, Gg^Em, Gg^Em, Gg, Gg, Gg, Gg, Gg, Gg
Gg, Gg, Gg, Gd^Em, Gd^Em, Gd^Em, Gd^Em, Gd^Em, Gd, Gd, Gd^Em, Gd^Em, Gd^Em, Gd, Gd, Gd, Gd, Gd, Hh, Hh, Hh, Hh, Hh, Hh, Hh, Hh, Gg, Gg, Gg, Gg, Gg, Gd^Em, Gd^Em, Gd^Em, Gd, Hh, Hh, Hh, Hh, Hh, Hh, Hh, Hh, Gd, Gd, Gs, Gs, Gs, Gs, Gs, Gs, Gs, Gs, Gg^Em, Gg^Em, Gg^Em, Gg, Gg, Gg, Gg, Gg, Gg
Gg, Gg, Gg, Gd, Gd, Gd^Em, Gd, Gd, Gd, Gd, Gd^Em, Gd^Em, Gd^Em, Gd^Em, Gd, Gd^Em, Gd, Gd, Gs, Hh, Hh, Hh, Hh, Hh, Gg, Gg, Gg, Gg, Gg, Gg, Gg, Gd, Gd, Gd, Gd, Gd, Gd, Hh, Hh, Hh, Gd^Emf, Hh, Gd, Gd, Gd, Gs, Gs, Gs, Gs, Gs, Gs, Gs, Gs, Gs, Gs, Gg, Gg, Gg, Gg, Gg, Gg, Gg
Gg, Gg, Gg, Gd, Gd, Gd, Gd, Gd, Gd, Gd, Gd, Gd^Em, Gd, Gd, Gd, Gd, Gs, Gs, Gs, Gs, Gs, Gg, Gg, Gg, Gg, Gg, Gg, Gg, Gg, Gg, Gg, Gd, Gd, Gd, Gd, Gd, Gd^Emf, Gd^Emf, Gd^Emf, Gd^Emf, Gd^Emf, Gd^Emf, Gd, Gd, Gd, Gs, Gs, Gs, Gs, Gs, Gs, Gs^Es, Gs, Gs, Gs^Es, Gg, Gg, Gg, Gg, Gg, Gg, Gg
Gg, Gg, Gg, Gd, Gd, Gd, Gd, Gd, Gd, Gd, Gd, Gd, Gd, Gd, Gs, Gs, Gs, Gs, Gs, Gs, Gs, Gg, Gg, Gg, Gg, Gg, Gg, Gg, Gg, Gg, Re, Gd^Vhr, Gd, Gd, Gd, Gd, Gd, Gd^Emf, Gd^Emf, Gd^Emf, Gd, Gd, Gd, Gd, Gs, Gs, Gs, Gs, Gs, Gs, Gs, Gs, Gs, Gs, Gs, Gg, Gg, Gg^Es, Gg, Gg, Gg^Efm, Gg^Efm
Gg, Gg, Gg, Gg, Gg, Gd, Gd, Gd, Gd, Gd, Gd, Gd, Gs, Gs, Gs, Gs, Gs, Gs, Gs, Gs, Gs, Gg, Gg, Gg, Gg, Gg, Hh^Vhh, Hh, Re, Re, Gg, Re, Re, Gd, Hh, Gd, Gd, Gd, Gd, Gd, Gd, Gd, Gs, Gs, Gs, Gs, Gs^Es, Gs, Gs, Gs, Gs, Gs, Gs^Es, Gs, Gs, Gg, Gg, Gg, Gg, Gg^Efm, Gg^Efm, Gg^Efm
Gg, Gg, Gg, Gg, Re, Re, Re, Gd, Gd, Gd, Gs, Gs, Gs, Gs, Gs, Gs, Gs, Gs^Es, Gs^Es, Gs, Gs, Gg, Gg, Gg, Gg^Es, Gg, Re, Re, Gg, Gg, Gg, Gg^Es, Gg^Es, Re, Re, Gd, Gd, Gd, Gd, Gd, Gs, Gs, Gs, Gs, Gs, Gs^Es, Gs^Es, Gs, Gs, Gs, Gs, Gs^Es, Re, Gs^Es, Gs, Gg, Gg, Gg, Gg, Gg^Efm, Gg, Gg^Efm
Gg, Gg, Re, Re, Gs, Gs^Es, Gs^Es, Re, Re, Gs, Re, Gs, Gs, Gs, Gs, Gs, Gs, Gs^Es, Gs^Es, Gs, Gs, Gg, Gg, Gg^Es, Re, Re, Gg, Gg, Gs^Fds, Gg, Gs^Fds, Gg, Gg, Gg^Es, Gg, Re, Re, Re, Re, Gs, Gs, Gs, Gs, Gs, Gs, Gs, Gs, Gs, Gs, Gs, Re, Re, Gs, Re, Re, Gg, Gg, Gg, Gg, Gg^Efm, Gg^Efm, Gg^Efm
Re, Re, Gs^Es, Gs, Gs, Gs, Gs, Gs, Gs, Re, Gs, Re, 1 Re, Gs, Gs, Gs, Gs, Gs, Gs, Gs, Gs, Gs^Fds, Re, Re, Gg, Gg, Gs^Fds, Gs^Fds, Gs^Fds, Gs^Fds, Gs^Fds, Gs^Fds, Gs^Fds, Gg, Gg, Gg, Gs, Gs, Gs, Re, Re, Gs, Gs^Es, Gs, Gs, Gs, Gs^Fds, Gs, Re, Re, Gs^Fds, Gs^Fds, Gs, Gs, Gs^Es, Re, Re, Gg, Gg, Gg^Efm, Re, Re
Gg, Gs^Es, Gs, Gs, Gs, Gs, Gs^Es, Gs, Gs, Gs, Gs, Gs, Gs, Re, Re, Gs, Gs, Gs, Hh, Gs, Re, Re, Gg, Gg, Gs^Fds, Gs^Fds, Gs^Fds, Gs^Fds, Gs^Fds, Gs^Fds, Gs^Fds, Gs^Fds, Gs^Fds, Gs^Fds, Gs^Fds, Gs^Fds, Gs^Fds, Gs, Gs, Gs^Vc, Gs, Re, Re, Gs^Es, Gs^Es, Gs, Re, Re, Gs^Vc, Gs, Gs, Gs, Gs, Gs, Gs, Gs, Gs, Re, Re, Re, Gg^Efm, Gg^Efm
Gg, Gs, Gs, Gs, Gs, Gs, Gs^Es, Gs^Es, Gs, Gs, Gs, Gs, Gs, Gs, Gs, Re, Re, Hh, Re, Re, Gs, Hh, Gg, Gg, Gs^Fds, Gs^Fds, Gs^Fds, Gs^Fds, Gs^Fds, Gs^Fds, Gs^Fds, Gs^Fds, Gs^Fds, Gs^Fds, Gs^Fds, Gs^Fds, Gs^Fds, Gs^Fds, Gs^Fds, Gs, Gs, Gs, Hh, Re, Re, Re, Gs, Gs, Gs, Gs, Gs, Gs, Gs, Gs, Gs, Gs, Gg, Gg, Gg^Efm, Gg^Efm, Gg^Efm, Gg^Efm
Gg, Gs, Gs, Gs, Gs, Gs, Gs, Gs, Gs, Gs, Gs^Es, Gs, Gs, Gs, Gs, Gs, Gs^Es, Re, Gs^Es, Gs, Gs, Gg, Gg, Gg, Gs^Fds, Gs^Fds, Gs^Fds, Gs^Fds, Gs^Fds, Gs^Fds, Gs^Fds, Gs^Fds, Gs^Fds, Gs^Fds, Gs^Fds, Gs^Fds, Gs^Fds, Gs^Fds, Gs^Fds, Gs^Fds, Gg, Gg, Gg, Hh, Gs, Gs, Gs, Gs, Gs, Gs, Gs, Gs, Gs, Gs, Gs, Gs, Gg, Gg, Gg, Gg^Efm, Gg^Efm, Gg^Efm
Gg, Gg, Gg, Gs, Gs, Gs, Gs, Gs, Gs, Gs^Es, Gs^Es, Gs, Gs, Gs, Gs, Gs, Gs, Gs^Es, Gs, Gs, Gs, Gg, Gg, Gg, Gs^Fds, Gs^Fds, Gs^Fds, Gs^Fds, Gs^Fds, Gs^Fds, Gs^Fds, Gs^Fds, Gs^Fds, Gs^Fds, Gs^Fds, Gs^Fds, Gs^Fds, Gs^Fds, Gs^Fds, Gs^Fds, Gg, Gg, Gg, Gg, Gg, Gs, Gs, Gs, Gs, Gs, Gs, Gs, Gs, Gs, Gs, Gs, Gg, Gg, Gg, Gg, Gg, Gg
Gg, Gg, Gg, Gs, Gs, Gs, Gs, Gs, Gs, Gs, Gs, Gs, Gs, Gs, Gs, Gs, Gs, Gs, Gs, Gs, Gs, Gg, Gg, Gg, Gs^Fds, Gs^Fds, Gs^Fds, Gs^Fds, Gs^Fds, Gs^Fds, Gs^Fds, Gs^Fds, Gs^Fds, Gs^Fds, Gs^Fds, Gs^Fds, Gs^Fds, Gs^Fds, Gs^Fds, Gs^Fds, Gg, Gg, Gg, Gg, Gg, Gg, Gg, Gs, Gs, Gs, Gs, Gs, Gg, Gs, Gg, Gg, Gg, Gg, Gg, Gg, Gg, Gg
