border_size=1
usage=map

Gg, Gg, Gg, Gg, Gg, Gg, Gg, Gg, Gg, Gg, Gg, Gg, Gg, Gg, Gg^Efm, Gg^Efm, Gg^Efm, Gg^Efm, Gg^Efm, Gg^Efm, Gg^Efm, Gg^Efm, Gg^Efm, Gg, Gg^Efm, Gg, Gg, Gg, Gd, Gd, Gd, Gd
Gg, Gg, Gg, Gg, Gg, Gg, Gg, Gg, Gg, Gg, Gg, Gg, Gg^Efm, Gg^Efm, Gg^Gvs, Gg^Efm, Gg^Wm, Gg^Efm, Gg^Efm, Gg^Efm, Gg^Efm, Gg^Efm, Gg^Gvs, Gg^Efm, Gg^Efm, Gg^Efm, Gg^Efm, Gg, Gd, Gd, Gd, Gd
Gg, Gg, Gg, Gg, Gg, Gg, Gg, Gg, Gg, Gg, Gg^Efm, Gg^Efm, Gg^Gvs, Gg^Gvs, Gg^Gvs, Gg^Gvs, Gg^Gvs, Gg^Efm, Gg^Efm, Gg^Efm, Gg^Gvs, Gg^Gvs, Gg^Gvs, Gg^Gvs, Gg^Gvs, Gg^Wm, Gg^Efm, Gg, Gg, Gd, Gd, Gd
Gg, Gg, Gg, Gg, Gg, Gg, Gg, Gg, Gg^Efm, Gg^Efm, Gg^Efm, Gg^Efm, Gg^Efm, Gg^Gvs, Gg^Gvs, Gg^Gvs, Gg^Efm, Gg^Efm, Gg^Efm, Gg^Efm, Gg^Efm, Gg^Gvs, Gg^Gvs, Gg^Gvs, Gg^Efm, Gg^Efm, Gg^Efm, Gg^Efm, Gg, Gd, Gd, Gd
Gg, Gg, Gg, Gg, Ch, Gg, Ch, Gg, Ch, Gg^Efm, Ch, Gg^Efm, Ch, Gg^Efm, Ch, Gg^Efm, Kh, Gg^Efm, Gg, Gg^Efm, Kh, Gg^Efm, Ch, Gg^Efm, Ch, Gg^Efm, Gg, Gg, Gg, Gg, Gg, Gd
Gg, Gg, Gg, Ch, Gd, Ch, Gd, Ch, Gd, Ch, Gd, Ch, Gd, Ch, Gd, Ch, Rr, Rr, Rr, Rr, Rr, Ch, Rr, Ch, Rr, Ch, Gg, Gg, Gg, Gg, Gg, Gg
Gg, Gg, Gg, Ch, Gd, Gd, Gd, Gd, Gd, Gd, Gd, Gd, Gd, Gd, Gs^Vc, Gd, Rr, Rr, Rr, Rr, Rr, Rr, Rr, Rr, Rr, Ch, Gg, Gg, Gg, Gg, Gg, Gg
Gg, Gg, Gg, Ch, Gd, Gd, Gd, Gs^Vc, Gd, Gd, Gd, Gd, Gd, Gd, Gd, Gd, Rr, Rr, Rr, Rr, Rr, Rr, Gs^Vh, Rr, Rr, Ch, Gg, Gg, Gg, Gg, Gg, Gg
Gg, Gg, Gg, Ch, Gd, Gd, Gd, Gd, Gd, Gd, Gd, Gd, Gd, Gd, Gd, Gd, Rr, Rr, Rr, Rr, Rr, Rr, Rr, Rr, Rr, Ch, Gg, Gg, Gg, Gg, Gg^Gvs, Gg^Gvs
Gg, Gg, Gg, Ch, Gd, Gd, Gd, Gd, Gd, Gs^Vc, Gd, Gd, Gd, Gd, Gs^Vc, Gd, Rr, Rr, Rr, Rr, Rr, Rr, Rr, Rr, Rr, Kh, Gg, Gg, Gg, Gg^Gvs, Gg^Gvs, Gg^Gvs
Gg, Gg, Gg, Ch, Gd, Gd, Gd, Gd, Gd, Gd, Gd, Gd, Gd, Gd, Gd, Gd, Rr, Rr, Rr, Rr, Rr, Rr, Rr, Rr, Rr, Rr, Gg, Gg, Gg, Gg, Gg, Gg^Gvs
Gg, Gg, Gg, Ch, Gd, Gd, Gd, Gd, Gd, Gd, Gd, Gd, Gd, Gd, Gd, Gd, Rrc, Rrc, Rrc, Rr, Rr, Rr, Rrc, Rr, Rr, Rr, Gg, Gg, Gg, Gg, Gg, Gg
Gg, Gg, Gg, Ch, Gd, Gd, Gd, Gs^Vc, Gd, Gd, Gd, Gd, Gd, Gd, Rrc, Rrc, Rrc, 1 Rrc, Rrc, Rrc, Rrc, Rrc, Rrc, Rrc, Rrc, Kh, Gg, Gg, Gg, Gg, Gg, Gg
Gg, Gg, Gg, Ch, Gd, Gd, Gd, Gd, Gd, Gd, Gd, Gd, Rrc, Rrc, Rrc, Rrc, Rrc, Rrc, Rrc, Rrc, Rrc, Rrc, Rrc, Gs^Vh, Rrc, Ch, Gg, Gg, Gg, Gg, Gg, Gg
Gg, Gg, Gg, Ch, Gd, Gd, Gd, Gd, Gd, Gd, Rrc, Rrc, Rrc, Rrc, Gs^Vh, Rrc, Rrc, Rrc, Ch, Rrc, Rrc, Rrc, Rrc, Rrc, Rrc, Ch, Gg, Gg, Gg, Gg, Gg^Gvs, Gg
Gg, Gg, Gg, Ch, Gd, Gd, Gd, Gd, Rrc, Rrc, Rrc, Rrc, Rrc, Rrc, Rrc, Rrc, Rrc, Ch, 2 Kh, Ch, Rrc, Rrc, Rrc, Rrc, Rrc, Ch, Gg, Gg, Gg^Gvs, Gg^Gvs, Gg^Gvs, Gg^Gvs
Gg, Gg, Gg^Efm, Ch, Gd, Gd, Rrc, Rrc, Rrc, Rrc, Rrc, Rrc, Rrc, Rrc, Rrc, Rrc, Rrc, Ch, Ch, Ch, Rrc, Rrc, Rrc, Rrc, Rrc, Ch, Gg, Gg, Gg, Gg^Gvs, Gg^Gvs, Gg^Gvs
Gg^Efm, Gg^Efm, Gg^Efm, Ch, Gg, Rrc, Rrc, Rrc, Rrc, Rrc, Rrc, Rrc, Rrc, Rrc, Gs^Vh, Rrc, Rrc, Rrc, Rrc, Rrc, Rrc, Rrc, Gs^Vh, Rrc, Rrc, Ch, Gg, Gg, Gg, Gg, Gg, Gg
Gg^Efm, Gg^Efm, Gg^Efm, Ch, Gg, Gg, Gg, Rrc, Rrc, Rrc, Rrc, Rrc, Rrc, Rrc, Rrc, Rrc, Rrc, Rrc, Rrc, Rrc, Rrc, Rrc, Rrc, Rrc, Rrc, Ch, Gg, Gg, Gg, Gg, Gg, Gg
Gg^Efm, Gg^Efm, Gg^Efm, Ch, Gg, Gg, Gg, Gg, Gg, Rrc, Rrc, Rrc, Rrc, Rrc, Rrc, Rrc, Rrc, Rrc, Rrc, Rrc, Rrc, Rrc, Rrc, Rrc, Rrc, Ch, Gg, Gg, Gg, Gg, Gg, Gg
Gg^Efm, Gg^Efm, Gg^Efm, Ch, Gg, Gg, Gg, Gg, Gg, Gg, Gg, Rrc, Rrc, Rrc, Rrc, Rrc, Rrc, Rrc, Rrc, Rrc, Rrc, Gs^Vh, Rrc, Rrc, Rrc, Ch, Gg, Gg, Gg, Gg, Gg, Gg
Gg, Gg^Efm, Gg^Efm, Ch, Gg, Gg, Gg, Gg, Gg, Gg, Gg, Gg, Gg, Rrc, Rrc, Rrc, Rrc, Rrc, Rrc, Rrc, Rrc, Rrc, Rrc, Rrc, Rrc, Ch, Gg^Efm, Gg^Efm, Gg, Gg, Gg, Gg
Gg, Gg^Efm, Gg^Efm, Ch, Gg, Gg, Gg, Gg, Gg, Gg, Gg, Gg, Gg, Gg, Gg, Rrc, Rrc, Rrc, Rrc, Rrc, Rrc, Rrc, Rrc, Rrc, Ch, Ch, Gg^Efm, Gg^Efm, Gg, Gg, Gg, Gg
Gg, Gg^Efm, Gg^Efm, Ch, Gg, Gg, Gg, Gg, Gg, Gg, Gg, Gg, Gg, Gg, Gg, Gg, Gg, Rrc, Rrc, Rrc, Rrc, Rrc, Ch, Ch, Gg^Efm, Gg^Efm, Gg^Efm, Gg^Efm, Gg, Gg, Gg, Gg
Gg, Gg^Efm, Gg^Efm, Ch, Gg, Gg, Gg, Gg, Gg, Gg, Ch, Ch, Ch, Gg, Gg, Gg, Gg, Gg, Gg, Rrc, Ch, Ch, Gg^Efm, Gg^Efm, Gg^Efm, Gg^Efm, Gg, Gg, Gg, Gg, Gg, Gg
Gg, Gg^Efm, Gg^Efm, Ch, Gg, Gg, Gg, Gg, Gg, Gg, Ch, Kh, Ch, Gg, Gg, Gg, Gg, Gg, Ch, Ch, Gg^Efm, Gg^Efm, Gg^Efm, Gg^Efm, Gg, Gg, Gg, Gg, Gg, Gg, Gg, Gg
Rrc, Gg^Efm, Gg^Efm, Ch, Kh, Gg, Gg, Gg, Gg, Gg, Gg, Ch, Gg, Gg, Gg, Gg, Ch, Ch, Gg^Efm, Gg^Efm, Gg^Efm, Gg^Efm, Gg, Gg, Gg, Gg, Gg, Gg, Gg, Gg, Gg, Gg
Gg, Rrc, Rrc, Gg^Efm, Rrc, Rrc, Kh, Gg, Gg, Gg, Gg, Gg, Gg, Gg, Ch, Ch, Gg^Efm, Gg^Efm, Gg^Efm, Gg^Efm, Gg, Gg, Gg, Gg, Gg, Gg, Gg, Gg, Gg, Gg, Gg, Gg
Gg, Gg, Gg^Efm, Rrc, Rrc, Gg^Efm, Gg^Efm, Ch, Ch, Gg, Gg^Efm, Gg, Ch, Ch, Gg^Efm, Gg^Efm, Gg^Efm, Gg^Efm, Gg, Gg, Gg, Gg, Gg, Gg, Gg, Gg, Gg, Gg, Gg, Gg, Gg, Gg
Gg, Gg, Gg, Gg^Efm, Gg^Efm, Rrc, Gg^Efm, Gg^Efm, Gg^Efm, Ch, Ch, Ch, Gg^Efm, Gg^Efm, Gg^Efm, Gg^Efm, Gg, Gg, Gg, Gg, Gg, Gg, Gg, Gg, Gg, Gg, Gg, Gg, Gg, Gg, Gg, Gg
Gg, Gg, Gg, Gg, Gg, Rrc, Gg^Efm, Gg^Efm, Gg^Efm, Gg^Efm, Gg^Efm, Gg^Efm, Gs^Vh, Gg^Efm, Gg, Gg, Gg, Gg, Gg, Gg, Gg, Gg, Gg, Gg, Gg, Gg, Gg, Gg, Gg, Gg, Gg, Gg
Gg, Gg, Gg, Gg, Gg, Rrc, Gg, Gg^Efm, Gg, Gg^Efm, Gg, Gg^Efm, Gg, Gg, Gg, Gg, Gg, Gg, Gg, Gg, Gg, Gg, Gg, Gg, Gg, Gg, Gg, Gg, Gg, Gg, Gg, Gg
