border_size=1
usage=map

Gd, Gd, Gd, Gd, Gd, Gd, Gd, Gd, Hh, Hh, Mm, Mm, Mm, Mm, Mm, Mm, Mm, Mm, Mm, Mm, Mm, Mm, Mm, Mm, Mm, Mm, Mm, Mm, Mm, Mm, Mm, Mm, Mm, Mm, Mm, Mm, Mm, Mm, Mm, Mm, Mm, Mm, Mm, Mm, Mm, Mm
Gd, Gd, Gd, Gd, Gd, Gd, Gd, Gd, Hh, Hh, Hh, Mm, Mm, Mm, Mm, Mm, Mm, Mm, Mm, Mm, Mm, Mm, Mm, Mm, Mm, Mm, Mm, Mm, Mm, Mm, Mm, Mm, Mm, Mm, Mm, Mm, Mm, Mm, Mm, Mm, Mm, Mm, Mm, Mm, Mm, Mm
Gd, Gd, Gd, Gd, Gd^Emf, Gd, Gd, Gd, Gd, Hh, Hh, Hh, Hh, Mm, Hh, Mm, Hh^Vhh, Mm, Hh, Mm, Hh, Mm, Mm, Mm, Mm, Mm, Mm, Mm, Mm, Mm, Mm, Mm, Mm, Mm, Mm, Mm, Mm, Mm, Hh, Mm, Hh, Mm, Hh, Mm, Mm, Mm
Gd, Gd, Gd^Emf, Gd^Emf, Gd^Emf, Gd^Emf, Gd^Emf, Gd, Gd, Gd, Gd, Hh, Gd, Hh, Gd, Hh, Gd, Hh, Hh, Hh, Hh, Hh, Hh, Hh, Hh, Mm, Mm, Mm, Mm, Mm, Mm, Mm, Mm, Mm, Mm, Mm, Mm, Hh, Hh, Hh, Hh, Hh, Hh, Hh, Hh, Hh
Gd^Emf, Gd^Emf, Gd^Emf, Gd^Emf, Gd^Emf, Gd^Emf, Gd^Emf, Gd^Emf, Gd, Gd, Gd, Gd, Gd, Gd, Gd, Gd, Gd, Gd, Gd, Hh, Gd, Hh, Hh, Hh^Vhh, Hh, Hh, Gd, Mm, Hh, Hh, Hh, Mm, Hh, Hh, Hh, Mm, Hh, Hh, Hhd^Fdf, Hhd^Fdf, Gs^Vc, Hhd^Fdf, Hhd^Fdf, Hh, Hhd^Fdf, Hh
Gd, Gd^Emf, Gd^Emf, Gd^Emf, Gd^Emf, Gd^Emf, Gd, Gd, Gd, Gd, Gd, Gd, Gd, Gd, Gd, Gd, Gd, Gd, Gd, Gd, Gd, Gd, Gd, Gd, Gd, Gd, Gd, Gd, Gd, Hh^Vhh, Hh, Hh, Hh, Hh^Vhh, Hh, Hh, Hh, Hh, Hhd^Fdf, Hhd^Fdf, Re, Hhd^Fdf, Hhd^Fdf, Hhd^Fdf, Hhd^Fdf, Hhd^Fdf
Gd, Gd, Gd, Gd^Emf, Gd, Gd, Gd, Gd, Gd, Gd, Gd, Gd^Em, Gd^Em, Gd, Gd, Gd, Gd, Gd, Gd, Gd, Gd, Gd, Gd, Gd, Gd, Gd, Gd, Gd, Gd, Gd, Gd, Gll, Gll, Hhd^Fdf, Hhd^Fdf, Hhd^Fdf, Hhd^Fdf, Hhd^Fdf, Hhd^Fdf, Re, Gll, Gll, Gll, Hhd^Fdf, Gll, Hhd^Fdf
Gd, Gd, Gd, Gd, Gd, Gd, Rb, Rb, Rb, Gd^Vhr, Gd, Gd^Em, Gd^Em, Gd, Gd, Gd, Gd, Gd, Gd, Gd, Gd, Gd, Gd, Gd, Gd, Gd, Gd, Gd, Gd, Gd, Gs, Gll, Gg^Eff, Gll, Gll, Gll, Gll, Hhd^Fdf, Gs^Vc, Re, Gll, Gll, Gll, Gll, Gll, Gll
Gd, Gd, Gd^Vhr, Gd, Rb, Gd^Vhr, Gd, Gd, Rb, Gd, Gd, Gd, Gd, Gd, Gd, Gd, Gs, Gs, Gs, Gd, Gs, Gd, Gs, Gs, Gs, Gs, Gs, Gs, Gs, Gs, Gg^Eff, Gg^Eff, Gg^Gvs, Gg^Gvs, Gg^Gvs, Gll, Gll, Gll, Gg, Re, Re, Gg, Gg, Gg, Gg, Gg
Gd, Gd, Gd, Rb, Rb, Gd^Em, Gd^Em, Gd, Rb, Rb, Rb, Gd, Gd, Gd, Gd, Gs, Gs, Gs, Gs, Gs, Gs, Gs, Gs, Gs, Gs^Es, Gs, Gs, Gs, Gs, Gg^Eff, Gg^Eff, Gg^Gvs, Gg^Gvs, Gg^Gvs, Gg^Gvs, Gg^Gvs, Gg, Gg, Gg, Gg, Re, Re, Gs^Vh, Gg, Gg, Gg
Gd^Em, Gd, Gd, Gd, Rb, Gd^Em, Gd, Rb, Chr, Chr, Chr, Rb, Gd, Gd, Gd, Gs, Gs, Gs, Gs, Gs, Gs, Gs, Gs, Gs^Es, Gs^Es, Gs, Gs, Gs, Gs^Es, Gs, Gs, Gg^Wm, Gg^Eff, Gg^Gvs, Gg, Gg, Gg, Gg, Gg, Re, Ce, Ce, Ce, Gg, Gg, Gg
Gd^Em, Gd^Em, Gd, Gd, Gd^Vhr, Gd, Gd, Gd^Vhr, Chr, 4 Khr, Chr, Gd^Vhr, Gd, Gd, Gd, Gs, Gs, Gs, Gs, Gs, Gs, Gs, Gs, Gs, Gs, Gs, Gs, Gs^Es, Gs^Es, Gs, Gg, Gg, Gg, Gg^Eff, Gg, Gg, Gg, Gg, Gg, Gs^Vh, Ce, 1 Ke, Ce, Gg, Gg, Gg
Gd, Gd, Ch, Ch, Ch, Hh, Gd, Gd, Gd, Chr, Gd, Rb, Hh, Gd, Gd, Gs, Gs, Gs, Hh, Gs, Gs, Gs, Gs, Gs, Hh, Gs, Gs, Gs, Gs, Gg, Gg, Gg, Gg, Gg, Gg, Gg, Gg, Gg, Gg, Re, Re, Ce, Gs^Vh, Gg, Gg, Gg
Gd, Gd, Ch, 3 Kh, Ch, Gd^Vhr, Gd, Gd, Gd, Gd, Gd, Rb, Re, Gd, Gd, Gs, Gs, Hh, Re, Hh, Gs, Gs, Gs, Hh, Re, Gs, Gs, Gs, Gs, Gg, Gg, Gg, Re, Gg, Re, Gg, Gg, Gg, Re, Re, Gg, Re, Gg, Gg, Gg, Gg
Gd, Gd, Gd, Ch, Gd^Vhr, Hh, Gd, Gd, Rb, Rb, Rb, Rb, Hh, Re, Re, Gs, Re, Re, Hh, Re, Re, Gs, Re, Re, Gs, Re, Re, Gs, Gs, Gg, Re, Re, Gg, Re, Gg, Re, Re, Re, Gg, Gg, Gg, Gg, Gg, Gg, Gg, Gg
Gd, Gd, Gd, Gd, Rb, Gd, Gd, Rb, Chr, Chr, Chr, Rb, Hh, Gd, Gd, Re, Gs, Gs, Gs, Gs, Gs, Re, Gs^Es, Gs^Es, Gs, Gs, Gs, Re, Re, Re, Gg, Gg, Gg, Gg, Gg, Gg, Gg, Re, Re, Gg, Rr^Vhc, Rrc, Rrc, Gg, Gg, Gg
Gd, Gd, Gd, Gd^Vhr, Rb, Gd, Gd, Gd^Vhr, Chr, 5 Khr, Chr, Gd^Vhr, Gd, Gd, Gd, Gs, Gs, Gs, Gs, Gs, Hh, Gs, Gs, Gs, Gs, Gs, Gs, Hh, Gs, Gg, Gg, Gg, Gg, Gg, Gg, Gg, Gg, Gg, Gg, Rrc, Ch, Ch, Ch, Rrc, Gg, Gg
Gd, Gd, Gd, Rb, Gd, Gd, Gd, Rb, Gd, Chr, Gd, Gd, Gd, Gd, Gd, Gs, Gs, Gs, Gs, Gs, Gs, Gs, Gs, Gs, Gs, Gs, Gs, Gs, Gs, Gg, Gg, Gg, Gg, Gg, Gg, Gg, Gg, Gg, Gg, Rr^Vhc, Ch, 2 Kh, Ch, Rr^Vhc, Gg, Gg
Gd, Gd, Gd^Vhr, Rb, Rb, Gd, Rb, Rb, Gd, Gd, Gd, Gd, Gd, Gd, Gd, Gs, Gs, Gs, Gs, Gs, Gs, Gs, Gs^Es, Gs, Gs, Gs, Gs, Gs, Gs, Gg, Gg^Eff, Gg, Gg, Gg, Gg, Gg, Gg, Gg, Gg, Rrc, Rrc, Ch, Rr^Vhc, Rrc, Gg, Gg
Gd, Gd, Gd, Gd, Gd, Rb, Gd, Gd^Vhr, Gd, Gd, Gd, Gd, Gd, Gd, Gs, Gs, Gs, Gs, Gs, Gs, Gs, Gs^Es, Gs^Es, Gs, Gs, Gs, Gs, Gs, Gg^Eff, Gg^Eff, Gg^Gvs, Gg, Gg^Wm, Gg, Gg, Gg, Gg, Gg, Gg, Gg, Rrc, Rrc, Gg, Gg, Gg, Gg
Gd, Gd, Gd, Gd, Gd, Gd, Gd, Gd, Gd, Gd, Gd, Gd, Gd, Gs, Gs, Gs, Gs, Gs, Gs, Gs, Gs, Gs, Gs, Gs, Gs, Gs, Gg^Eff, Gg^Eff, Gg^Gvs, Gg^Gvs, Gg^Gvs, Gg^Gvs, Gg^Gvs, Gg, Gs, Gg, Gg, Gg, Rrc, Rrc, Gg, Gg, Gg, Gg, Gg, Gg
Gd, Gd, Gd, Gd, Gg, Gd, Gd, Gd, Gg, Gd, Gg, Gd, Gs, Gs, Gs^Es, Gs, Gs, Gs, Gs, Gs, Gs, Gs, Gs, Gs, Gll, Gs, Gs, Gg^Eff, Gg^Eff, Gg^Gvs, Gg^Gvs, Gg^Gvs, Gs, Gs, Gs, Gs, Gs, Gs^Vc, Gs, Rrc, Rrc, Gs^Vc, Gg, Gg, Gs, Gg
Gd, Gd, Gg, Gg, Gg, Gg, Gg, Gg, Gg, Gg, Gg, Gs, Gs, Gs^Es, Gs^Es, Gs, Gs, Gs, Gll, Gll, Gll, Gll, Gll, Gll, Gll, Gll, Gll, Gs, Gs, Gg^Eff, Gs, Gs, Gs, Gs, Gs, Gs, Gs^Es, Gs, Gs, Gs, Gs, Rrc, Rrc, Gs, Gs^Es, Gs
Gg, Gg, Gg, Gg, Gg, Gg, Gg, Gg, Gg, Gg, Gs, Gs, Gs, Gs, Gs, Gs, Gll, Gll, Gll, Gll, Gll, Gll, Gll, Gll, Gll, Gll, Gll, Gll, Gll, Gs, Gs, Gs, Gs, Gs, Gs, Gs, Gs, Gs^Es, Gs, Gs, Gs, Gs, Rrc, Gs, Gs, Gs
Gg, Gg, Gg, Gg, Gg, Gg, Gg, Gg, Gg, Gg, Gs, Gs, Gs, Gs, Gll, Gll, Gll, Gll, Gll, Gll, Gll^Fdf, Gll^Fdf, Gll^Fdf, Gll, Gll, Gll, Gll, Gll, Gll, Gll, Gll, Gs, Gs, Gs, Gs, Gs, Gs, Gs, Rrc, Gs^Vc, Rrc, Gs, Rrc, Gs, Gs, Gs
Gg, Gg, Gg, Gg, Gg, Gg, Gg, Gg, Gg, Gs, Gs, Gs, Gll, Gll, Gll, Gll, Gll, Gll, Gll^Fdf, Gll^Fdf, Gll^Fdf, Gll^Fdf, Gll^Fdf, Gll^Fdf, Gll^Fdf, Gll, Gll, Gll, Gll, Gll, Gll, Gll, Gll, Gll, Gll, Gs, Gll, Gs^Vc, Gll, Gll, Gll, Rrc, Rrc, Gs^Vc, Gs, Gs
Gg, Gg, Gg, Gg, Gg, Gg, Gg, Gg, Gg, Gs, Gs, Gs, Gll, Gll, Gll, Gll, Gll^Fdf, Gll^Fdf, Gll^Fdf, Gll^Fdf, Gll^Fdf, Gll^Fdf, Gll^Fdf, Gll^Fdf, Gll^Fdf, Gll^Fdf, Gll^Fdf, Gs^Vl, Gll^Fdf, Gll, Gll, Gll, Gll, Gll, Gll, Gll, Gll, Gll, Gll, Gll, Gll, Gll, Rrc, Gll, Gll, Gll
Gg, Gg, Gg, Gg, Gg, Gg, Gg, Gg, Gg, Gs, Gs, Gs, Gll, Gll, Gll, Gll^Fdf, Gll^Fdf, Gll^Fdf, Gll^Fdf, Gll^Fdf, Gll^Fdf, Gll^Fdf, Gll^Fdf, Gll^Fdf, Gll^Fdf, Gll^Fdf, Gll^Fdf, Gll^Fdf, Gll^Fdf, Gll^Fdf, Gll^Fdf, Gll, Gs^Vl, Gll, Gll, Gll, Gll, Gll, Gll, Gll, Gll, Gll, Rrc, Gll, Gll, Gll
Gg, Gg, Gg, Gg, Gg, Gg, Gg, Gg, Gg, Gs, Gs, Gll, Gll, Gll, Gll^Fdf, Gll^Fdf, Gll^Fdf, Gll^Fdf, Gll^Fdf, Gll^Fdf, Gll^Fdf, Gll^Fdf, Gll^Fdf, Gll^Fdf, Gll^Fdf, Gll^Fdf, Gll^Fdf, Gll^Fdf, Gll^Fdf, Gll^Fdf, Gll^Fdf, Gll^Fdf, Gll^Fdf, Gll^Fdf, Gll^Fdf, Gll^Fdf, Gll^Fdf, Gll^Fdf, Gll^Fdf, Gll, Gll^Fdf, Gll, Gs^Vc, Gll, Gll^Fdf, Gll^Fdf
Gg, Gg, Gg, Gg, Gg, Gg, Gg, Gg, Gg, Gg, Gg, Gll, Gll, Gll^Fdf, Gll^Fdf, Gll^Fdf, Gll^Fdf, Gll^Fdf, Gll^Fdf, Gll^Fdf, Gll^Fdf, Gll^Fdf, Gll^Fdf, Gll^Fdf, Gll^Fdf, Gll^Fdf, Gll^Fdf, Gll^Fdf, Gll^Fdf, Gll^Fdf, Gll^Fdf, Gll^Fdf, Gll^Fdf, Gll^Fdf, Gll^Fdf, Gll^Fdf, Gll^Fdf, Gll^Fdf, Gll^Fdf, Gll^Fdf, Gll^Fdf, Gll^Fdf, Gll^Fdf, Gll^Fdf, Gll^Fdf, Gll^Fdf
Gg, Gg, Gg, Gg, Gg, Gg, Gg, Gg, Gg, Gg, Gg, Gll, Gll, Gll^Fdf, Gll^Fdf, Gll^Fdf, Gll^Fdf, Gll^Fdf, Gll^Fdf, Gll^Fdf, Gll^Fdf, Gll^Fdf, Gll^Fdf, Gll^Fdf, Gll^Fdf, Gll^Fdf, Gll^Fdf, Gll^Fdf, Gll^Fdf, Gll^Fdf, Gll^Fdf, Gll^Fdf, Gll^Fdf, Gll^Fdf, Gll^Fdf, Gll^Fdf, Gll^Fdf, Gll^Fdf, Gll^Fdf, Gll^Fdf, Gll^Fdf, Gll^Fdf, Gll^Fdf, Gll^Fdf, Gll^Fdf, Gll^Fdf
Gg, Gg, Gg, Gg, Gg, Gg, Gg, Gg, Gg, Gg, Gg, Gll, Gll, Gll^Fdf, Gll^Fdf, Gll^Fdf, Gll^Fdf, Gll^Fdf, Gll^Fdf, Gll^Fdf, Gll^Fdf, Gll^Fdf, Gll^Fdf, Gll^Fdf, Gll^Fdf, Gll^Fdf, Gll^Fdf, Gll^Fdf, Gll^Fdf, Gll^Fdf, Gll^Fdf, Gll^Fdf, Gll^Fdf, Gll^Fdf, Gll^Fdf, Gll^Fdf, Gll^Fdf, Gll^Fdf, Gll^Fdf, Gll^Fdf, Gll^Fdf, Gll^Fdf, Gll^Fdf, Gll^Fdf, Gll^Fdf, Gll^Fdf
Gg, Gg, Gg, Gg, Gg, Gg, Gg, Gg, Gg, Gg, Gg, Gll, Gll, Gll^Fdf, Gll^Fdf, Gll^Fdf, Gll^Fdf, Gll^Fdf, Gll^Fdf, Gll^Fdf, Gll^Fdf, Gll^Fdf, Gll^Fdf, Gll^Fdf, Gll^Fdf, Gll^Fdf, Gll^Fdf, Gll^Fdf, Gll^Fdf, Gll^Fdf, Gll^Fdf, Gll^Fdf, Gll^Fdf, Gll^Fdf, Gll^Fdf, Gll^Fdf, Gll^Fdf, Gll^Fdf, Gll^Fdf, Gll^Fdf, Gll^Fdf, Gll^Fdf, Gll^Fdf, Gll^Fdf, Gll^Fdf, Gll^Fdf
Gg, Gg, Gg, Gg, Gg, Gg, Gg, Gg, Gg, Gg, Gg, Gll, Gll, Gll^Fdf, Gll^Fdf, Gll^Fdf, Gll^Fdf, Gll^Fdf, Gll^Fdf, Gll^Fdf, Gll^Fdf, Gll^Fdf, Gll^Fdf, Gll^Fdf, Gll^Fdf, Gll^Fdf, Gll^Fdf, Gll^Fdf, Gll^Fdf, Gll^Fdf, Gll^Fdf, Gll^Fdf, Gll^Fdf, Gll^Fdf, Gll^Fdf, Gll^Fdf, Gll^Fdf, Gll^Fdf, Gll^Fdf, Gll^Fdf, Gll^Fdf, Gll^Fdf, Gll^Fdf, Gll^Fdf, Gll^Fdf, Gll^Fdf
Gg, Gg, Gg, Gg, Gg, Gg, Gg, Gg, Gg, Gg, Gg, Gll, Gll, Gll^Fdf, Gll^Fdf, Gll^Fdf, Gll^Fdf, Gll^Fdf, Gll^Fdf, Gll^Fdf, Gll^Fdf, Gll^Fdf, Gll^Fdf, Gll^Fdf, Gll^Fdf, Gll^Fdf, Gll^Fdf, Gll^Fdf, Gll^Fdf, Gll^Fdf, Gll^Fdf, Gll^Fdf, Gll^Fdf, Gll^Fdf, Gll^Fdf, Gll^Fdf, Gll^Fdf, Gll^Fdf, Gll^Fdf, Gll^Fdf, Gll^Fdf, Gll^Fdf, Gll^Fdf, Gll^Fdf, Gll^Fdf, Gll^Fdf
