border_size=1
usage=map

Rb, Rb, Rb, Rb, Rb, Rb, Rb, Rb, Rb, Gg, Gg, Gg, Gg, Gg, Gg, Rrc, Gs, Gs, Gs, Gd, Gd, Gd, Hh, Hh, Hh, Hh, Hh, Hh, Hh, Hh, Hh, Hh, Hh, Gg, Gg, Gg, Rr
Rb, Rb, Rb, Rb, Rb, Rb, Rb, Rb, Rb, Gg, Gg, Gg, Gg, Gg, Gg, Rrc, Gs, Gs, Gd, Gd, Gd, Gd^Em, Hh, Hh, Hh, Hh, Hh, Hh, Hh, Hh, Hh, Hh, Ce, Gg, Rr, Rr, Gg
Rb, Rb, Rb, Rb, Rb, Rb, Rb, Rb, Rb, Gg, Gg, Gg, Gg, Gg, Gg, Rrc, Gs, Gs, Gd, Gd, Gd, Gd^Em, Gd^Em, Hh, Hh, Hh, Gs, Hh, Gs, Hh^Vhh, Gs, Ce, 1 Ke, Ce, Gg, Gg, Gg
Rrc, Rb, Rrc, Rrc, Rrc, Rb, Rb, Rb, Rb, Gg, Gg, Gg, Gg, Gg, Gg, Rrc, Rr, Gs, Gd, Gd, Rr, Gd, Rr, Gd, Rr, Gs, Gs, Gs, Gs, Gs, Rr, Ce, Ce, Ce, Gg, Gg, Hh
Gs, Rrc, Gs, Gs, Gs^Es, Rrc, Rrc, Rb, Rb, Gg, Gg, Gg, Gg, Gg, Gg, Rrc, Gs, Rr, Rr, Rr, Gs, Rr, Gs, Rr, Gs, Rr, Rr, Gs^Es, Rr, Rr, Gg, Gg, Gg, Hh^Vhh, Hh, Hh, Hh
Hh^Fp, Gs, Gs, Gs, Gs, Gs^Es, Gs^Es, Rrc, Rrc, Gg, Gg, Gg, Gg, Gg, Rrc, Rrc, Gs, Gs, Gs, Gs, Gs, Gs, Gs^Es, Gs, Gs, Gs, Gs^Es, Rr, Hh, Gg, Gg, Gg, Gg, Hh, Hh, Hh, Hh
Hh^Fp, Hh^Fp, Hh^Fp, Gs, Gs, Gs, Gs, Gs, Gd, Rrc, Rrc, Gg, Rrc, Rrc, Gd, Gd, Gd, Gs, Gs, Gs^Vc, Gs, Gs^Es, Gs^Es, Gs, Gs, Gs, Gs^Es, Rr, Hh, Gg, Gg, Gg, Gg, Hh, Hh, Hh, Hh
Hh^Fp, Hh^Fp, Hh^Fp, Hh^Fp, Hh^Fp, Gs, Gd, Gd, Gd, Gd, Gd, Rrc, Rrc, Gd, Gd, Gd, Gd, Gd, Gs, Gs, Gs, Gs, Gs, Gs, Gs^Vc, Gs, Hh, Rr, Gg, Gg, Gg, Gg, Gd, Hh, Hh, Hh, Hh
Hh^Fp, Hh^Fp, Hh^Fp, Hh^Fp, Hh^Fp, Gd, Gd, Gd, Gd, Gd, Gd, Gd, Gd, Rrc, Rrc, Gd, Gs, Gs, Gs, Gs, Gs, Gs, Gd, Gd, Gd, Gs, Rr, Rr, Rr, Gg, Gd, Gd, Gd, Gd^Emf, Gd^Emf, Hh, Gd
Hh^Fp, Hh^Fp, Hh^Fp, Hh^Fp, Hh^Fp, Gd, Gd, Gd, Gd, Gd, Gd, Gd, Gs, Gs, Gs, Rrc, Gs, Gs, Gs^Vc, Gs, Gs, Gd, Gd, Gd, Rrc, Rr, Gs^Es, Gs^Es, Gd, Rr, Rr, Gd, Gd, Gd^Emf, Gd, Gd, Gd
Hh^Fp, Hh^Fp, Hh^Fp, Hh^Fp, Hh^Fp, Gd, Gd, Gd, Gd, Gd, Gd, Gs, Gs^Vc, Gs, Gs, Rrc, Gs, Gs, Gs, Gs, Gs, Hh, Rrc, Rrc, Gs^Vc, Gs, Gs, Gs, Gd, Gd, Gd, Rr, Gd, Gd, Gd, Gd, Gd
Gll^Fp, Hh^Fp, Gll^Fp, Hh^Fp, Hh^Fp, Gs, Gs, Gd, Gd, Gd, Gd, Gs, Gs, Gs, Gs^Es, Rrc, Gs^Es, Gs^Es, Gs, Gs, Rrc, Rrc, Hh, Gs, Gs, Gs, Gd, Gd, Gd, Gd, Gd, Rr, Rr, Gd, Gd, Gd, Gs
Gll^Fp, Gll^Fp, Gll^Fp, Gll^Fp, Gll^Fp, Gs, Gs, Gs, Gs, Gs, Gs, Gs, Gs, Gs^Es, Rrc, Rrc, Rrc, Gs^Es, Rrc, Rrc, Rrc, Hh, Gs, Gs, Gs, Gd, Gd, Gd, Gd, Gd, Gd, Gs, Gs, Rr, Gs, Gs, Gs
Gll^Fp, Gll^Fp, Gll^Fp, Gll^Fp, Gll^Fp, Gs^Vl, Gs, Gs, Gs, Gs, Gs, Gs, Rrc, Rrc, Gs, Gs^Vc, Gs, Rrc, Gd, Gd, Gd, Rrc, Rrc, Gs, Gd, Gd, Gd, Gd, Gd, Gd, Gd, Gs, Gs, Rr, Gs, Gs, Gs
Gll^Fp, Gll^Fp, Gll^Fp, Gll^Fp, Gll^Fp, Gs, Gs, Gs, Hh, Hh, Rrc, Rrc, Hh, Gs, Gs, Gs, Gd, Gd, Gd, Gd, Gd, Gd, Gd, Rrc, Rrc, Gd, Gd, Gd, Rrc, Rrc, Rrc, Gs, Gs, Rr, Gs, Gs, Gs
Gll^Fp, Gll^Fp, Gll^Fp, Gll^Fp, Gll^Fp, Gs, Gs, Gs, Rrc, Rrc, Gs, Hh, Gs, Gs, Gs, Gd, Hh^Fp, Hh^Fp, Hh^Fp, Gd, Hh^Fp, Gd, Gd, Gd, Gs, Rrc, Rrc, Rrc, Gd, Gd, Gd, Rrc, Rrc, Rr, Gs, Gs, Gs
Gll^Fp, Gll^Fp, Gll^Fp, Gll^Fp, Gll^Fp, Gs, Ch, Ch, Ch, Hh, Gs, Gs, Gs, Gs, Gll^Fp, Hh^Fp, Hh^Fp, Hh^Fp, Hh^Fp, Hh^Fp, Hh^Fp, Hh^Fp, Hh^Fp, Gs, Gs, Gs, Gs, Gd, Gd, Gd, Gd, Gd, Gd, Rrc, Rrc, Gs, Gs
Gll^Fp, Gll^Fp, Gll^Fp, Gll^Fp, Gs, Gs, Ch, 2 Kh, Ch, Gd^Vhr, Gs, Gs, Gll^Fp, Gll^Fp, Gll^Fp, Gll^Fp, Gll^Fp, Hh^Fp, Hh^Fp, Hh^Fp, Hh^Fp, Hh^Fp, Hh^Fp, Hh^Fp, Hh^Fp, Hh^Fp, Hh^Fp, Gd, Hh^Fp, Gd, Gd, Gd, Gd, Gd, Gd, Rrc, Rrc
Gll^Fp, Gll^Fp, Rb, Rb, Rrc, Rrc, Rb, Ch, Rb, Gs, Gll^Fp, Gll^Fp, Gll^Fp, Gll^Fp, Gll^Fp, Gll^Fp, Gll^Fp, Gll^Fp, Gll^Fp, Hh^Fp, Hh^Fp, Hh^Fp, Hh^Fp, Hh^Fp, Hh^Fp, Hh^Fp, Hh^Fp, Hh^Fp, Hh^Fp, Hh^Fp, Gd, Gd, Gd, Gd, Gd, Gd, Gd
Rb, Rb, Rb, Rrc, Rb, Rb, Rb, Rb, Gll^Fp, Gll^Fp, Gll^Fp, Gll^Fp, Gll^Fp, Gll^Fp, Gll^Fp, Gll^Fp, Gll^Fp, Gll^Fp, Gll^Fp, Gll^Fp, Hh^Fp, Hh^Fp, Hh^Fp, Hh^Fp, Hh^Fp, Hh^Fp, Hh^Fp, Hh^Fp, Hh^Fp, Hh^Fp, Gd, Gd, Gd^Em, Gd^Em, Gd^Em, Gd, Gd
Rb, Rb, Rrc, Rrc, Rb, Rb, Gll^Fp, Gll^Fp, Gll^Fp, Gll^Fp, Gll^Fp, Gll^Fp, Gll^Fp, Gll^Fp, Gll^Fp, Gll^Fp, Gll^Fp, Gll^Fp, Gll^Fp, Gll^Fp, Hh^Fp, Hh^Fp, Hh^Fp, Hh^Fp, Hh^Fp, Hh^Fp, Hh^Fp, Hh^Fp, Hh^Fp, Hh^Fp, Gd, Gd, Gd, Gd^Em, Gd, Gd, Gd
Rrc, Rrc, Rb, Rb, Gll^Fp, Gll^Fp, Gll^Fp, Gll^Fp, Gll^Fp, Gll^Fp, Gll^Fp, Gll^Fp, Gll^Fp, Gll^Fp, Gll^Fp, Gll^Fp, Gll^Fp, Gll^Fp, Gll^Fp, Gll^Fp, Hh^Fp, Hh^Fp, Hh^Fp, Hh^Fp, Hh^Fp, Hh^Fp, Hh^Fp, Hh^Fp, Hh^Fp, Hh^Fp, Gd, Gd, Gd, Gd, Gd, Gd, Gd
