border_size=1
usage=map

Hhd^Fmf, Hhd^Fmf, Hhd^Fmf, Hhd^Fmf, Hhd^Fmf, Hhd^Fmf, Hhd^Fmf, Hhd^Fmf, Hhd^Fmf, Hhd^Fmf, Hhd^Fmf, Hhd^Fmf, Hhd^Fmf, Hhd^Fmf, Hhd^Fmf, Hhd^Fmf, Hhd^Fmf, Hhd^Fmf, Gll^Fmf, Gll^Fmf, Gll^Fmf, Gll^Fmf, Gll^Fmf, Gll^Fmf, Gll^Fmf, Gll^Fmf, Gll^Fmf, Gll, Gll, Gll, Gd, Gd, Gd, Gd, Gd, Gd, Gd, Gg, Gg, Gg, Gg, Gg, Gg, Gg, Gg, Gg, Gg
Hhd^Fmf, Hhd^Fmf, Hhd^Fmf, Hhd^Fmf, Hhd^Fmf, Hhd^Fmf, Hhd^Fmf, Hhd^Fmf, Hhd^Fmf, Hhd^Fmf, Hhd^Fmf, Hhd^Fmf, Hhd^Fmf, Hhd^Fmf, Hhd^Fmf, Hhd^Fmf, Hhd^Fmf, Hhd^Fmf, Gll^Fmf, Gll^Fmf, Gll^Fmf, Gll^Fmf, Gll^Fmf, Gll^Fmf, Gll^Fmf, Gll^Fmf, Gll^Fmf, Gll, Gll, Gll, Gd, Gd, Gd, Gd, Gd, Gd, Gd, Gg, Gg, Gg, Gg, Gg, Gg, Gg, Gg, Gg, Gg
Hhd^Fmf, Hhd^Fmf, Hhd^Fmf, Hhd^Fmf, Hhd^Fmf, Hhd^Fmf, Hhd^Fmf, Hhd^Fmf, Hhd^Fmf, Hhd^Fmf, Hhd^Fmf, Hhd^Fmf, Hhd^Fmf, Hhd^Fmf, Hhd^Fmf, Hhd^Fmf, Hhd^Fmf, Hhd^Fmf, Gll^Fmf, Gll^Fmf, Gll^Fmf, Gll^Fmf, Gll^Fmf, Gll^Fmf, Gll^Fmf, Gll^Fmf, Gll^Fmf, Gll, Gll, Gll, Gll, Gd, Gd, Gd, Gd^Vhr, Gd, Gd, Gg, Gg, Gg, Gg, Gg, Gg, Gg, Gg, Gg, Gg
Hhd^Fmf, Hhd^Fmf, Hhd^Fmf, Hhd^Fmf, Hhd^Fmf, Hhd^Fmf, Hhd^Fmf, Hhd^Fmf, Hhd^Fmf, Hhd^Fmf, Hhd^Fmf, Hhd^Fmf, Hhd^Fmf, Hhd^Fmf, Hhd^Fmf, Hhd^Fmf, Hhd^Fmf, Hhd^Fmf, Gll^Fmf, Gll^Fmf, Gll^Fmf, Gll^Fmf, Gll^Fmf, Gll^Fmf, Gll^Fmf, Gll^Fmf, Gll^Fmf, Gll, Gll, Gll, Gll, Gd, Gd, Gd, Gd, Gd, Gd, Gg, Gg, Gg, Gg^Em, Gg^Em, Gg^Em, Gg, Gg, Gg, Gg
Hhd^Fmf, Hhd^Fmf, Hhd^Fmf, Hhd^Fmf, Hhd^Fmf, Hhd^Fmf, Hhd^Fmf, Hhd^Fmf, Hhd^Fmf, Hhd^Fmf, Hhd^Fmf, Hhd^Fmf, Hhd^Fmf, Hhd^Fmf, Hhd^Fmf, Hhd^Fmf, Hhd^Fmf, Hhd^Fmf, Gll^Fmf, Gll^Fmf, Gll^Fmf, Gll^Fmf, Gll^Fmf, Gll^Fmf, Gll^Fmf, Gll^Fmf, Gll^Fmf, Gll, Gll, Gll, Chr, Gd, Gd, Gd, Gd, Gd, Gg, Gg, Gg, Gg, Gg, Gg^Em, Ss, Ss, Ss, Gg, Ss
Hhd^Fmf, Hhd^Fmf, Hhd^Fmf, Hhd^Fmf, Gd, Hhd^Fmf, Gll^Fmf, Gll^Fmf, Gll^Fmf, Hhd^Fmf, Hhd^Fmf, Hhd^Fmf, Hhd^Fmf, Hhd^Fmf, Hhd^Fmf, Hhd^Fmf, Hhd^Fmf, Gll^Fmf, Gll^Fmf, Gll^Fmf, Gll^Fmf, Gll^Fmf, Gll^Fmf, Gll^Fmf, Gll^Fmf, Gll^Fmf, Gll^Fmf, Gll, Gll, Chr, 3 Khr, Gd^Vhr, Gd, Gd, Gd, Gd, Gg^Em, Gg^Em, Gg, Gg, Ss, Ss, Ss^Vhs, Ss, Ss, Ss, Ss
Hhd^Fmf, Hhd^Fmf, Gd, Gd, Gd, Gd, Gd, Gll^Fmf, Gll^Fmf, Gll^Fmf, Gll^Fmf, Gll^Fmf, Gll^Fmf, Gll^Fmf, Gll^Fmf, Hhd^Fmf, Gll^Fmf, Gll^Fmf, Gll^Fmf, Gll^Fmf, Gll^Fmf, Gll^Fmf, Gll^Fmf, Gll^Fmf, Gll^Fmf, Gll^Fmf, Gll^Fmf, Gs^Vl, Gll, Chr, Chr, Chr, Gd, Gd, Gd, Gd, Gg, Gg^Em, Ss, Ss, Ss, Ss, Ss, Ss, Ss, Ss, Ss
Gd, Gd, Ce, Ce, Ce, Gd, Gd, Gd, Gd, Gll^Fmf, Gll^Fmf, Gll^Fmf, Gll^Fmf, Gll^Fmf, Gll^Fmf, Gll^Fmf, Gll^Fmf, Gll^Fmf, Gll^Fmf, Gll^Fmf, Gll^Fmf, Gll^Fmf, Gll^Fmf, Gll^Fmf, Gll^Fmf, Gll^Fmf, Gll^Fmf, Gll, Gll, Gll, Re, Gd, Gd, Gd, Gg, Gg, Ss, Ss, Ss, Ss, Ss, Ss, Ss, Ss, Ss, Ss, Ss
Gd, Gd^Vhr, Ce, 1 Ke, Ce, Gd, Gd, Gd, Gd, Gd, Gll, Gll^Fmf, Gll^Fmf, Gll^Fmf, Gll^Fmf, Gll^Fmf, Gll^Fmf, Gll^Fmf, Gll^Fmf, Gll^Fmf, Gll^Fmf, Gll^Fmf, Gll^Fmf, Gll^Fmf, Gll^Fmf, Gll^Fmf, Gll^Fmf, Gll, Gll, Gll, Re, Hh, Hh, Gg, Gg, Gg, Ss, Ss, Ss, Ss, Chs, Ss, Ss, Ss, Ss, Ss, Ss
Gd, Gd, Gd, Ce, Gd, Re, Re, Gd, Gd, Gd, Gll, Gll, Gll, Gll, Gs^Vl, Gll^Fmf, Gll, Gll^Fmf, Gll^Fmf, Gll^Fmf, Gll^Fmf, Gll^Fmf, Gll^Fmf, Gll^Fmf, Gll^Fmf, Gll^Fmf, Gll, Gll, Gll, Gll, Re, Hh, Gg, Gg, Gg, Gg, Ss, Ss, Ss^Vhs, Chs, 4 Khs, Chs, Ss^Vhs, Ss, Ss, Ss, Ss
Hh, Gd, Gd, Gd, Gd, Gd, Gd, Re, Re, Gd^Vhr, Gll, Gll, Gll, Gll, Gll, Gll, Gll, Gll, Gll, Gll, Gll, Gs^Vl, Gll, Gll^Fmf, Gll, Gll, Gll, Gll, Gg, Gg, Re, Gg, Gg, Gg, Gg, Gg, Ss, Ss, Ss, Chs, Chs, Chs, Ss, Ss, Ss, Ss, Ss
Mm, Hh, Hh, Gd, Gd, Gd, Gd, Gd, Gd, Re, Gd, Gll, Gll, Gll, Gll, Gll, Gll, Gll, Gll, Gll, Gll, Gll, Gll, Gll, Gll, Gll, Gg^Es, Gg^Es, Gs^Vc, Gg, Re, Re, Re, Gg, Gg, Gg, Ss, Ss, Ss, Ss^Vhs, Ss, Ss, Ss, Ss, Ss, Ss, Ss
Mm, Mm, Mm, Hh, Hh, Gd, Gd, Gd, Gd, Re, Re, Gd, Gd, Gll, Re, Gll, Ce, Ce, Re, Gd, Gd, Gll, Gd, Gll, Gg, Gg, Gg, Gg, Re, Re, Gg, Hh, Hh, Re, Re, Gg, Ss^Bw/r, Ss^Bw/r, Ss, Ss, Ss, Ss, Ss, Ss, Ss, Ss, Ss
Mm, Mm, Mm, Mm, Mm, Hh, Hh, Gd, Gd, Gd, Gd^Vhr, Re, Re, Re, Gd^Dr, Re, Ce, 2 Ke, Gd^Dr, Re, Re, Gd, Gd, Gg, Gg^Es, Gg^Es, Re, Re, Gg^Dr, Gg, Gg, Gg, Gg, Gg, Gg, Re, Ss^Bw\r, Ss, Ss, Ss^Vhs, Ss, Ss, Ss, Ss, Ss, Ss, Ss
Mm, Mm, Mm, Mm, Mm, Mm, Mm, Hh, Hh, Gd, Gd, Gd, Gd, Gd, Gd, Gd, Gd, Ce, Gd, Gd, Gd, Re, Re, Gg^Es, Re, Re, Gg, Gg, Gg, Gg, Gg, Gg, Gg, Gg, Gg, Gg, Ss, Ss^Bw\r, Ss, Ss, Ss, Ss, Ss, Ss, Ss, Ss, Ss
Mm, Mm, Mm, Mm, Mm, Mm, Mm, Mm, Hh, Hh, Hh, Hh, Hh, Hh, Hh, Gd, Hh, Gd, Gd, Gd, Gd, Gd, Gg, Re, Re, Gs^Vc, Gg, Gg, Gg, Gg, Gg, Gg, Gg, Gg, Gg, Gg, Ss, Ss, Ss, Ss, Chs, Ss^Vhs, Ss, Ss, Ss, Ss, Ss
Mm, Mm, Mm, Mm, Mm, Mm, Mm, Mm, Mm, Hh, Mm, Hh, Hh, Hh, Hh, Hh, Hh, Hh, Hh, Gd, Gd, Gd, Gg, Gg^Dr, Re, Gg, Gg, Gg, Gg, Gg, Gd, Gd, Gd, Gd, Gd, Gg, Ss, Ss, Ss^Vhs, Chs, 5 Khs, Chs, Ss, Ss, Ss, Ss, Ss
Mm, Mm, Mm, Mm, Mm, Mm, Mm, Mm, Mm, Mm, Mm, Mm, Mm, Mm, Mm, Hh^Vhh, Mm, Hh, Hh, Hh, Hh, Gg, Gg, Gg, Re, Gg, Gg, Gg, Gg, Gd, Gd, Gd^Vhr, Gd, Gd, Gd, Gd, Ss, Ss, Ss, Chs, Chs, Chs, Ss, Ss, Ss, Ss, Ss
Mm, Mm, Mm, Mm, Mm, Mm, Mm, Mm, Mm, Mm, Mm, Mm, Mm, Mm, Mm, Mm, Mm, Mm, Mm, Hh, Hh, Gg, Gg^Emf, Gg^Emf, Gg^Emf, Re, Re, Gg, Gd, Gd, Gd, Gd, Gd, Gd, Gd, Gd, Ss, Ss, Ss, Ss, Ss, Ss^Vhs, Ss, Ss, Ss, Ss, Ss
Mm, Mm, Mm, Mm, Mm, Mm, Mm, Mm, Mm, Mm, Mm, Mm, Mm, Mm, Mm, Mm, Mm, Mm, Mm, Hh, Hh, Gg^Emf, Gg^Emf, Gg^Emf, Gg^Emf, Gg^Emf, Re, Gd, Gd, Gd, Gd, Gd, Gd, Gd, Gd, Gd, Gd, Ss, Ss, Ss, Ss, Ss, Ss, Ss, Ss, Ss, Ss
Mm, Mm, Mm, Mm, Mm, Mm, Mm, Mm, Mm, Mm, Mm, Mm, Mm, Mm, Mm, Mm, Mm, Mm, Mm, Hh, Hh, Gg, Gg, Gg^Emf, Gg, Gg, Re, Gd, Gd, Gd, Gd, Gd, Gd, Gd, Gd, Gd, Gd, Gd, Gd, Ss, Ss, Ss, Ss, Ss, Ss, Ss, Ss
Mm, Mm, Mm, Mm, Mm, Mm, Mm, Mm, Mm, Mm, Mm, Mm, Mm, Mm, Mm, Mm, Mm, Mm, Mm, Hh, Hh, Gg, Gg, Gg, Gg, Gg, Re, Gd, Gd, Gd, Gd, Gd, Gd, Gd, Gd, Gd, Gd, Gd, Gd, Gd, Gd, Ss, Ss, Ss, Ss, Ss, Ss
