border_size=1
usage=map

Gg, Gg, Gg, Gg, Gg, Gg, Gg, Gg, Ww, Gg, Gg, Gg, Rb, Gg, Gg, Gg, Gg, Gg, Gg^Efm, Gg, Gg, Gg, Gs^Fms, Gs^Fms, Gs^Fms, Gg, Gg
Ww, Gg, Gg, Gg, Gg, Gg, Ww, Gg, Ww^Bw\, Gg, Gg, Gg, Rb, Gg, Gs, Gg, Gg, Gg, Gg^Efm, Gg^Efm, Gg^Efm, Gg, Gs^Fms, Gs^Fms, Gs^Fms, Gg, Gg
Gg, Ww^Bw/, Ww, Ww, Ww, Ww, Gg, Ww, Gs, Gs, Gs, Gs, Rb, Gs^Vh, Gs, Gg, Gg, Gg, Gs, Gg^Efm, Gs, Gs^Em, Gs, Gs^Fms, Gs, Gs, Gs
Gg^Gvs, Gg, Gg, Gg, Gg^Efm, Gg^Efm, Gg^Efm, Gs, Gs, Gs, Gs, Gs, Gs^Fms, Rb, Rb, Gg, Rb, Gs, Gs^Vh, Gs, Gs^Fms, Gs, Gs, Gs, Gs^Fms, Gs, Rb
Gg^Gvs, Gg^Gvs, Gg^Gvs, Gg, Gg, Gg^Efm, Gs, Gs, Gs^Em, Gs^Em, Gs^Fms, Gs^Fms, Gs^Fms, Gs^Fms, Gs^Fms, Rb, Gs, Rb, Rb, Rb, Rb, Rb, Rb, Gs^Em, Rb, Rb, Gs^Fms
Gg^Gvs, Gg^Gvs, Gg^Wm, Gg, Gs, Gs, Gs, Gs, Gs^Fms, Gs^Fms, Gs^Fms, Gs^Fms, Gs^Fms, Gs^Fms, Gs^Em, Gs, Gs, Gd^Es, Gd, Gs, Gs, Gd^Es, Gs, Rb, Rb, Gs^Fms, Gs
Gs, Gg, Gg, Gg, Gg, Gs, Gs, Gs^Em, Gs^Fms, Gs^Fms, Gs^Fms, Gs^Fms, Gs^Fms, Gs^Fms, Gs, Gs, Gg, Gd, Gd, Gg, Gd, Gd, Gs, Gs^Vh, Rb, Gs, Gg
Gs, Gs, Gs, Gg, Gg, Gg, Gg, Gs^Fms, Gs^Fms, Gs^Fms, Gs^Fms, Gs^Fms, Gs^Fms, Gs^Em, Gg, Gg, Gg, Gg, Gs, Gd, Gd, Gd, Gs, Gs, Rb, Gg, Gg
Gs, Gs, Gg, Gg, Gg, Gg, Gg, Gs, Gs, Gs^Fms, Gs^Fms, Gs^Fms, Gs^Fms, Gs^Fms, Gg, Gg, Gd, Gd, Gd, Gs, Rb, Rb, Rb, Rb, Gs^Fms, Gg, Gg
Gg, Gg, Gg, Gg, Gg^Efm, Gg^Efm, Gg^Efm, Gg^Efm, Gg, Gg, Gg, Gs, Gg, Gg, Gg, Gg, Gd, Gd^Ecf, Rb, Rb, Gs, Gs, Gs, Rb, Gs^Fms, Gg, Gg
Gg, Gg, Gs, Gg^Efm, Gg^Efm, Gg^Efm, Gg^Efm, Gg^Efm, Gg, Gg, Gd, Gg, Gg, Gg, Gs, Gs, Rb, Rb, Gg, Gs^Vh, Gg, Gs, Gg, Rb, Rb, Gg, Gg
Gg, Gs, Gll^Fp, Gs, Gs, Gg^Efm, Gg^Efm, Gg, Gg, Gd, Gd, Gg, Gg, Gs, Gs^Fms, Rb, Gg^Efm, Gg^Efm, Gg^Efm, Gg, Gg, Gg, Gg, Gg, Gg^Efm, Rb, Rb
Gll^Fp, Gll^Fp, Gll^Fp, Gll^Fp, Gs^Em, Gs, Gg, Gg, Gg, Gd, Gd, Gg, Gg, Gs, Gs, Rb, Gg^Efm, Gg^Efm, Gs, Gg, Gg^Efm, Gg, Gg, Gg, Gg^Efm, Gg^Efm, Gg^Efm
Gll^Fp, Gll^Fp, Gll^Fp, Gll^Fp, Gll^Fp, Gs, Gs, Gg, Gg, Gg, Gg, Gg, Gg, Gg, Gd, Rb, Gs, Gs, Gs, Gs, Gg^Efm, Gg^Efm, Gg^Efm, Gg, Gg, Gg^Efm, Gg^Efm
Gll^Fp, Gll^Fp, Gll^Fp, Gll^Fp, Gg, Gg, Gg, Gg, Gs, Gs, Gs, Gg, Gg, Gd, Gd^Ecf, Rb, Gs, Gs, Gs, Gs, Gg, Gg^Efm, Gg^Efm, Gg, Gg, Gg, Gg
Gll^Fp, Gll^Fp, Gll^Fp, Gll^Fp, Gg, Gg, Gg, Gg, Gg, Gs, Gs, Gg, Gg, Gd, Gd, Rb, Gs, Gs, Gs, Gg, Gg, Gg, Gg, Gg, Ww^Bw|, Gg, Gg
Gll^Fp, Gll^Fp, Gs, Gg, Gg, Gg, Gg, Gg, Gg, Gs, Gs, Gg, Gg, Gs, Gs^Vh, Rb, Gg, Gs, Gg, Gg, Gg, Gg, Ww, Ww, Gg, Ww, Ww
Gs, Gs^Em, Gs, Gg, Ce, Gg, Gs, Gg, Gg, Gg, Gg, Gg, Gg^Es, Gs, Rb, Rb, Gs^Vh, Gg, Gg, Ww, Ww, Gg, Ww^Bw\, Gg, Gg, Gg, Gg^Efm
Gs, Gs, Gg, Ce, 1 Ke, Ce, Gs, Gs, Gs, Gg, Gg^Es, Gg^Es, Rb, Rb, Gs, Gg, Gg, Gg, Gg^Efm, Gg, Gg, Ww, Gg, Gg, Gg, Gg^Efm, Gg^Efm
Gg^Es, Gg^Es, Gg^Es, Ce, Ce, Ce, Rb, Gs, Rb, Rb, Rb, Rb, Gs, Gs, Gs, Gg, Gg, Gg^Efm, Gg^Efm, Gg^Efm, Gg, Gg, Gg, Gg, Gg^Wm, Gg^Efm, Gg^Efm
Gg^Es, Gg^Es, Rb, Rb, Rb, Rb, Gg^Es, Rb, Gg, Gg^Es, Gg^Es, Gs, Gs, Gs, Gs, Gg, Gg, Gg^Efm, Gg^Efm, Gg^Efm, Gg, Gg, Gg^Gvs, Gg^Gvs, Gg^Gvs, Gg, Gg
Rb, Rb, Gll^Fp, Gll^Fp, Gg, Gg, Gg, Gg, Gg, Gg, Gg, Gg, Gg, Gg, Gg, Gg, Gg, Gg, Gg, Gg, Gg, Gg^Gvs, Gg^Gvs, Gg^Gvs, Gg^Gvs, Gg^Gvs, Gg
