border_size=1
usage=map

Uu, Uu, Uu, Uu, Uu, Uu, Uu, Uu, Ql, Ql, Ql, Ql, Ql, Ql, Ql, Ql, Ql, Ql, Ql, Ql, Ql, Ql, Ql, Ql, Uu, Uu, Uu, Uu, Uu, Uu, Uu, Uu, Ql, Ql, Ql, Ql, Ql, Ql, Ql, Ql, Ql, Ql, Ql, Ql, Ql, Ql, Ql, Uu, Uu, Uu, Uu, Uu, Uu, Uu, Uu, Uu, Uu, Uu, Uu, Uu, Uu, Uu
Uh, Uh, Uu^Vu, Cud, Cud, Cud, Uu^Vu, Uu, Ql, Ql, Ql, Ql, Ql, Ql, Ql, Ql, Ql, Ql, Ql, Ql, Ql, Ql, Ql, Ql, Uu, Uu, Uu^Uf, Uu^Uf, Uu^Uf, Uu^Uf, Uu, Uu, Ql, Ql, Ql, Ql, Ql, Ql, Ql, Ql, Ql, Ql, Ql, Ql, Ql, Ql, Ql, Uu, Uu, Uu, Uu, Uu, Uu, Uu, Uu, Uu^Vu, Cud, Uu, Uu, Uu, Uu, Uu
Uh, Uh, Cud, Cud, 6 Kud, Cud, Cud, Uu, Ql, Ql, Ql, Ql, Ql, Ql, Ql, Ql, Ql, Ql, Ql, Ql, Ql, Ql, Ql, Ql, Uu, Uu, Cud, Uu^Uf, Cud, Uu^Uf, Cud, Uu, Ql, Ql, Ql, Ql, Ql, Ql, Ql, Ql, Ql, Ql, Ql, Ql, Ql, Ql, Ql, Uu, Uu, Uu^Vu, Uu^Emf, Uu, Uu, Uu, Uu^Vu, Cud, 7 Kud, Cud, Uu^Vu, Uu, Uu, Uu
Ql, Uh, Uu, Cud, Cud, Cud, Uh, Uh, Ql, Ql, Ql, Ql, Ql, Ql, Ql, Ql, Ql, Ql, Ql, Ql, Ql, Ql, Uu, Uu, Uu, Uu, Cud, Cud, 2 Kud, Cud, Cud, Uu, Uu, Ql, Ql, Ql, Ql, Ql, Ql, Ql, Ql, Ql, Ql, Ql, Ql, Ql, Ql, Uu, Uu, Uu^Emf, Uu^Emf, Uu^Emf, Uu^Emf, Uu, Uu, Cud, Cud, Cud, Uu, Uu, Uu, Uu
Ql, Ql, Ql, Uu, Uu, Uh, Uu, Uu, Ql, Ql, Ql, Ql, Ql, Ql, Ql, Ql, Ql, Ql, Ql, Ql, Uu, Uu, Uu, Uu, Uu, Uu, Cud, Cud, Cud, Cud, Cud, Uu, Uu, Uu, Uu, Ql, Ql, Ql, Ql, Ql, Ql, Ql, Ql, Ql, Ql, Ql, Ql, Uu, Uu, Uu, Uu, Uu^Emf, Uu, Uu, Uue, Uu, Uu, Uu, Uu, Uu, Uu, Uu
Ql, Ql, Ql, Ql, Ql, Uu, Uu, Uu, Ql, Ql, Ql, Ql, Ql, Ql, Ql, Ql, Ql, Ql, Ql, Ql, Uu, Uu, Uu, Uu, Uu, Uu, Uu, Uu, Uu, Uu, Uu, Uu, Uu, Uu, Uu, Uu, Uu, Ql, Ql, Ql, Ql, Ql, Ql, Ql, Ql, Ql, Ql, Uu, Xu, Uu, Xue, Xue, Xue, Uue, Uue, Uue, Uue, Uu, Uu, Uu, Uu, Uu
Ql, Ql, Ql, Ql, Ql, Ql, Ql, Uu, Ql, Ql, Ql, Ql, Ql, Ql, Ql, Ql, Ql, Ql, Ql, Ql, Xue, Uu, Uu, Uu, Uu, Uu, Uu, Uu, Uu, Uu, Uu, Uu, Uu, Uu, Uu^Vu, Uu, Uu, Uu, Uu, Ql, Ql, Ql, Ql, Ql, Ql, Ql, Xu, Xu, Xue, Xue, Xue, Xue, Xue, Xue, Xue, Uue, Uue, Uue, Uu, Uu^Vu, Uu, Uu
Ql, Ql, Ql, Ql, Ql, Ql, Uu, Uu, Ql, Ql, Ql, Ql, Ql, Ql, Ql, Ql, Ql, Ql, Xue, Xue, Xue, Xue, Uue, Uue, Uue, Uu, Uu, Uu, Uu, Uu, Uu, Uu, Uu, Uu, Uu, Uu, Qxua, Qxua, Qxua, Uu, Uu, Uu, Uu, Ql, Uu, Xu, Xue, Xue, Xue, Xue, Xue, Xue, Xue, Xue, Xue, Xue, Xue, Uue, Uu, Uu, Kud, Uu
Ql, Ql, Ql, Ql, Ql, Ql, Ql, Uu, Uu, Ql, Uu, Uu, Uu, Ql, Uu, Uu, Xue, Xue, Xue, Xue, Xue, Xue, Xue, Uue, Uue, Uue, Uue, Uu^Vu, Uu, Uu, Uu, Uu, Uu, Uu, Uu, Qxua, Qxua, Qxua, Qxua, Qxua, Qxua, Uu, Uu, Uu, Xue, Xue, Xue, Xue, Xue, Xue, Xue, Xue, Xue, Xue, Xue, Xue, Xue, Xue, Xue, Uu, Uu, Uu
Ql, Ql, Ql, Ql, Ql, Ql, Ql, Ql, Uu, Uu, Uu, Uu, Qxu, Uu, Uu, Uu, Uue, Xue, Xue, Xue, Xue, Xue, Xue, Xue, Xue, Uue, Uue, Uue, Uu, Kud, Uu, Uu^Vu, Qxua, Qxua, Qxua, Uu, Uu^Vu, Uu, Qxua, Qxua, Uu, Uu, Uu, Xue, Xue, Xue, Xue, Xue, Xue, Xue, Xue, Xue, Xue, Xue, Xue, Xue, Xue, Xue, Xue, Xue, Uu, Uu
Ql, Ql, Ql, Ql, Ql, Ql, Ql, Ql, Uu, Uu, Qxu, Qxu, Qxu, Qxu, Uu, Uue, Uue, Xue, Xue, Xue, Xue, Xue, Xue, Xue, Xue, Xue, Xue, Xue, Xue, Uu, Xue, Uu, Uu, Qxua, Qxua, Qxua, Qxua, Uu, Uu, Uu, Xue, Xue, Xue, Uu, Uu, Xue, Xue, Xue, Xue, Xue, Xue, Xue, Xue, Xue, Xue, Xue, Xue, Xue, Xue, Uu, Uu, Uu
Uu, Ql, Uu, Uu, Uu, Uu, Uu, Uu, Uu, Qxu, Qxu, Qxu, Qxu, Qxu, Uu, Uue, Uue, Uue, Uue, Xue, Xue, Xue, Xue, Xue, Xue, Xue, Xue, Xue, Xue, Xue, Xue, Xue, Xue, Uu, Uu, Uu, Uu, Uu, Xue, Xue, Xue, Xue, Xue, Xue, Xue, Uu, Uu, Xue, Xue, Xue, Xue, Xue, Xue, Xue, Xue, Xue, Xue, Xue, Uu, Uu, Uu, Uu
Xue, Uu, Xue, Uu, Xue, Uu, Xue, Uu, Xue, Uu, Uu, Uu, Uu, Qxu, Uu, Uue, Uue, Uue, Xue, Xue, Xue, Xue, Uu, Xue, Xue, Xue, Xue, Xue, Xue, Xue, Xue, Xue, Xue, Xue, Xue, Xue, Xue, Uu, Xue, Xue, Xue, Xue, Xue, Xue, Xue, Xue, Xue, Uu, Uu, Xue, Xue, Xue, Xue, Xue, Xue, Xue, Uu, Uu, Uu, Uu, Uu, Uu
Xue, Xue, Xue, Xue, Xue, Xue, Xue, Xue, Xue, Xue, Xue, Xue, Xue, Uu, Kud, Uue, Xue, Uue, Xue, Xue, Xue, Xue, Xue, Uu, Uu, Xue, Xue, Xue, Xue, Xue, Xue, Xue, Xue, Xue, Xue, Xue, Xue, Xue, Xue, Xue, Xue, Xue, Xue, Xue, Xue, Xue, Xue, Xue, Xue, Uu, Uu, Xue, Xue, Xue, Uu, Uu, Xue, Xue, Xue, Xue, Uu, Uu
Xue, Xue, Xue, Xue, Xue, Xue, Xue, Xue, Xue, Xue, Xue, Xue, Xue, Xue, Uu, Uu, Xue, Xue, Xue, Xue, Xue, Xue, Xue, Xue, Uu, Uu, Uu, Xue, Xue, Xue, Xue, Xue, Xue, Xue, Xue, Xue, Xue, Xue, Xue, Xue, Xue, Xue, Xue, Xue, Xue, Xue, Xue, Xue, Xue, Xue, Uu, Uu, Uu, Uu, Xue, Uu, Xue, Xue, Xue, Xue, Uu, Uu
Xue, Xue, Xue, Xue, Xue, Xue, Xue, Xue, Xue, Xue, Xue, Xue, Xue, Xue, Uu, Uu, Xue, Xue, Xue, Xue, Xue, Xue, Xue, Xue, Xue, Uu, Uu, Uu, Uu, Xue, Xue, Xue, Xue, Xue, Xue, Xue, Xue, Xue, Xue, Xue, Xue, Xue, Xue, Xue, Xue, Xue, Xue, Xue, Uu, Uu, Xue, Uu, Xue, Xue, Xue, Xue, Xue, Xue, Xue, Xue, Uu, Uu
Xue, Xue, Uu, Xue, Uu, Xue, Xue, Xue, Xue, Xue, Xue, Xue, Xue, Xue, Uu, Xue, Xue, Xue, Xue, Xue, Xue, Xue, Xue, Xue, Xue, Uu, Uu, Uu^Vu, Cud, Uu, Uu, Xue, Xue, Xue, Xue, Xue, Xue, Xue, Xue, Xue, Xue, Xue, Uu, Xue, Uu, Xue, Uu, Uu, Xue, Uu, Xue, Xue, Xue, Xue, Xue, Xue, Xue, Xue, Uu, Uu, Uu, Uu
Uu, Uu, Uu, Uu, Uu, Uu, Uu, Uu, Uu, Xue, Uu, Uu, Uu, Xue, Uu, Xue, Xue, Xue, Xue, Xue, Xue, Xue, Xue, Xue, Xue, Uu, Uu^Vu, Cud, 4 Kud, Cud, Uu^Vu, Uu, Uue, Xue, Xue, Xue, Xue, Xue, Xue, Xue, Uu, Uu, Xue, Uu, Xue, Uu, Xue, Xue, Xue, Xue, Xue, Xue, Xue, Xue, Xue, Xue, Xue, Xue, Uu, Uu, Xue, Xue
Xue, Xue, Xue, Xue, Xue, Xue, Xue, Xue, Xue, Uu, Xue, Uu, Xue, Uu, Uu, Xue, Xue, Xue, Xue, Xue, Xue, Xue, Xue, Xue, Xue, Uu, Uu, Cud, Cud, Cud, Uu, Uue, Uue, Uue, Uue, Xue, Xue, Xue, Uu, Uu, Xue, Xue, Xue, Xue, Xue, Xue, Xue, Xue, Xue, Xue, Xue, Xue, Xue, Xue, Xue, Xue, Uu, Uu, Xue, Xue, Uu, Xue
Xue, Xue, Xue, Xue, Xue, Xue, Xue, Xue, Xue, Xue, Xue, Xue, Xue, Xue, Xue, Uu, Uu, Uu, Uu, Xue, Uue, Xue, Xue, Xue, Uu, Uu, Uu, Uu, Uu, Uu, Uu, Uue, Uue, Uue, Uue, Uue, Uu, Uu, Xue, Xue, Xue, Xue, Xue, Xue, Xue, Xue, Xue, Xue, Xue, Xue, Xue, Xue, Uu, Uu, Uu, Uu, Xue, Xue, Uu, Uu, Uu, Uu
Xue, Xue, Xue, Xue, Xue, Xue, Xue, Xue, Xue, Xue, Xue, Xue, Xue, Xue, Xue, Xue, Uu, Xue, Xue, Uu, Uu, Xue, Uu, Uu, Xue, Uu, Uu, Uu, Uu, Uu, Uu^Uf, Uu, Uu, Uu, Uu, Uu, Uu, Uu, Uu, Xue, Xue, Xue, Xue, Xue, Xue, Xue, Xue, Xue, Xue, Xue, Uu, Uu, Uu, Uu, Xue, Xue, Uu, Uu, Cud, Uu^Vu, Uu, Uu
Xue, Xue, Xue, Xue, Xue, Xue, Xue, Xue, Xue, Xue, Xue, Xue, Xue, Xue, Xue, Xue, Uu, Xue, Xue, Xue, Xue, Uu, Xue, Xue, Xue, Xue, Xue, Uu, Uu, Uu^Uf, Uu^Uf, Uu^Uf, Uu^Uf, Uu, Uu, Uu, Uu, Uu, Uu, Uu, Uu, Xue, Xue, Xue, Xue, Xue, Xue, Xue, Xue, Xue, Uu, Uu, Xue, Xue, Uu, Uu, Uu^Vu, Cud, 3 Kud, Cud, Uu^Vu, Uu
Xue, Xue, Xue, Xue, Xue, Xue, Xue, Xue, Xue, Xue, Xue, Xue, Xue, Xue, Xue, Xue, Uu, Xue, Xue, Xue, Xue, Xue, Xue, Xue, Xue, Xue, Xue, Xue, Uu, Uu^Uf, Uu^Uf, Uu^Uf, Uu, Uu, Uu, Uu, Uu, Uu^Vu, Uu, Uu, Uu, Uu, Uu, Uu, Uu, Xue, Xue, Xue, Uu, Uu, Xue, Xue, Xue, Xue, Uu, Uu, Uu, Cud, Cud, Cud, Uu, Uu
Xue, Xue, Xue, Xue, Xue, Xue, Xue, Xue, Xue, Xue, Xue, Xue, Xue, Xue, Xue, Xue, Xue, Uu, Uu, Xue, Xue, Xue, Xue, Xue, Xue, Xue, Xue, Xue, Uu, Uu, Uu, Uu, Uh, Uu, Uh, Uu, Uu, Uu, Uu, Uh, Uh, Uu, Uu, Uu, Uu, Uu, Uu, Uu, Xue, Xue, Xue, Xue, Xue, Xue, Uu, Uu, Uu, Uu, Uu, Uu, Uu, Uu
Xue, Xue, Xue, Xue, Xue, Xue, Xue, Xue, Xue, Xue, Xue, Xue, Xue, Xue, Uu, Uu, Uu, Xue, Xue, Uu, Uu, Xue, Xue, Xue, Xue, Xue, Xue, Xue, Uu, Uu, Uu, Uu^Vu, Uh, Uh, Uh, Uh, Uu, Uu, Uu, Uh, Uh, Uu, Uu, Uu, Uu, Uu, Xue, Xue, Xue, Xue, Xue, Xue, Xue, Xue, Uu, Uu, Uu, Uu, Uu, Uu, Uu, Uu
Uu, Xue, Uu, Xue, Uu, Xue, Uue, Xue, Uue, Xue, Uue, Uue, Uu, Uu, Uh, Uh, Uh, Uu, Uu, Xue, Xue, Uu, Uu, Xue, Xue, Xue, Xue, Xue, Xue, Uu, Uu, Uu, Uu, Uh, Uh, Uh, Uu, Uu, Uu, Uh, Uu, Uu, Uu, Uu, Xue, Xue, Xue, Xue, Xue, Xue, Xue, Xue, Xue, Xue, Uu, Uu, Uu, Uu, Uu, Uu, Uu, Uu
Uu, Uu, Cud, Uu, Uu, Uu, Uue, Uue, Uue, Uue, Uue, Uue, Uu, Uu, Uu, Uh, Uu, Uu, Uu, Uu, Xue, Xue, Uu, Xue, Xue, Xue, Xue, Xue, Xue, Xue, Xue, Uu, Uue, Uu, Uu, Uu, Uu, Kud, Uu, Uu^Vu, Uu, Uu, Uu, Uu, Uu, Xue, Xue, Xue, Xue, Xue, Xue, Xue, Xue, Xue, Uu, Uu^Vu, Uu, Uu, Uu, Uu, Uu, Uu
Uu, Cud, 5 Kud, Cud, Uu^Vu, Uu, Uu, Uue, Uue, Uue, Uue, Uue, Uu, Uu, Uu, Uu, Uu^Emf, Uu^Emf, Xue, Xue, Xue, Xue, Uu, Xue, Xue, Xue, Xue, Xue, Xue, Xue, Xue, Xue, Xue, Uue, Uue, Uue, Uue, Uu, Uu, Uu, Uu, Uu, Xue, Xue, Xue, Uu, Uu, Xue, Xue, Xue, Xue, Xue, Uu, Uu, Uu, Uu, Uu, Uu, Uu, Uu, Uu, Uu
Uu, Cud, Cud, Cud, Uu, Uu, Uh, Uu, Uu, Uue, Uu, Uu, Uh, Uh, Uh, Uu, Xue, Xue, Xue, Xue, Xue, Xue, Uu, Xue, Xue, Xue, Xue, Xue, Xue, Xue, Xue, Xue, Xue, Xue, Xue, Uue, Uue, Uu, Uu, Uu, Xue, Xue, Xue, Xue, Xue, Xue, Xue, Uu, Uu, Xue, Uu, Uu, Uu, Uu, Kud, Uu, Uu, Uu, Uu^Emf, Uu^Vu, Uu, Uu
Uu, Uu^Vu, Uu, Uu^Vu, Uu, Uh, Uh, Uu, Uu, Uu, Uu, Uu, Uu, Uu, Uu, Uu, Xue, Xue, Xue, Xue, Xue, Xue, Uu, Xue, Xue, Xue, Xue, Xue, Xue, Xue, Xue, Xue, Xue, Xue, Xue, Xue, Xue, Uu, Uu, Xue, Xue, Xue, Xue, Xue, Xue, Xue, Xue, Xue, Uu, Uu, Xue, Xue, Xue, Uu, Uu, Uu, Uu^Emf, Uu^Emf, Uu^Emf, Uu, Uu, Uu
Uu, Uu, Uu^Emf, Uu, Uu, Uu, Uu, Uu, Uu^Emf, Uu^Emf, Uu^Emf, Uu, Uu, Uu^Vu, Uu, Uu, Xue, Xue, Xue, Xue, Xue, Xue, Uu, Xue, Xue, Xue, Xue, Xue, Xue, Xue, Xue, Xue, Xue, Xue, Xue, Xue, Uu, Uu, Uu, Xue, Xue, Xue, Xue, Xue, Xue, Xue, Uu, Uu, Xue, Xue, Xue, Xue, Xue, Xue, Xue, Uu, Xue, Uu^Emf, Xue, Uu, Xue, Uu
Uu^Emf, Uu^Emf, Uu^Emf, Uu^Emf, Uu, Uu, Uu, Uu^Emf, Uu^Emf, Uu^Emf, Uu^Emf, Uu, Uu, Uu, Uue, Uue, Xue, Xue, Xue, Xue, Xue, Xue, Xue, Uu, Uu, Uu, Xue, Xue, Xue, Xue, Xue, Xue, Xue, Xue, Uu, Uu, Xue, Xue, Xue, Uu, Uu, Xue, Xue, Xue, Uu, Uu, Xue, Xue, Xue, Xue, Xue, Xue, Xue, Xue, Xue, Xue, Xue, Xue, Xue, Xue, Xue, Xue
Uu, Uu^Emf, Uu, Uu, Uu, Uu, Uu, Uu, Uu, Uu, Uu^Vu, Uu, Uu, Uue, Uue, Uue, Xue, Xue, Xue, Xue, Xue, Xue, Xue, Xue, Xue, Uu, Uu, Xue, Xue, Xue, Xue, Xue, Uu, Uu, Xue, Xue, Xue, Xue, Xue, Xue, Xue, Uu, Uu, Uu, Xue, Xue, Xue, Xue, Xue, Xue, Xue, Xue, Xue, Xue, Xue, Xue, Xue, Xue, Xue, Xue, Xue, Xue
Uu, Uu, Uu, Uu, Uu, Uu, Uu, Uu, Uu, Uu, Uu, Uu, Uu, Uue, Uue, Uue, Xue, Xue, Xue, Xue, Xue, Xue, Xue, Xue, Xue, Xue, Xue, Uu, Uu, Xue, Uu, Uu, Xue, Xue, Xue, Xue, Xue, Xue, Xue, Xue, Xue, Xue, Uu, Xue, Xue, Xue, Xue, Xue, Xue, Xue, Xue, Xue, Xue, Xue, Xue, Xue, Xue, Xue, Xue, Xue, Xue, Xue
Uu, Uu, Uu, Uu^Vu, Uu, Uu, Uh, Uh, Uh, Uu, Uu, Kud, Uu, Uu, Uu, Uue, Xue, Xue, Xue, Xue, Xue, Xue, Xue, Xue, Xue, Xue, Xue, Xue, Uu, Uu, Xue, Xue, Xue, Xue, Xue, Xue, Xue, Xue, Xue, Xue, Xue, Uu, Xue, Xue, Xue, Xue, Xue, Xue, Xue, Xue, Xue, Xue, Xue, Xue, Xue, Xue, Xue, Xue, Xue, Xue, Xue, Xue
Uue, Uu, Uu, Uu, Uh, Uh, Uh, Uh, Uh, Uh, Uh, Uu, Xue, Xue, Xue, Uu, Uu, Xue, Uu, Xue, Xue, Xue, Xue, Xue, Xue, Xue, Uu, Uu, Xue, Xue, Xue, Xue, Xue, Xue, Xue, Xue, Xue, Xue, Xue, Xue, Xue, Uu, Xue, Xue, Xue, Xue, Xue, Xue, Xue, Xue, Xue, Xue, Xue, Xue, Xue, Xue, Xue, Xue, Xue, Xue, Xue, Xue
Uue, Uue, Uue, Uu, Uh, Uh, Uh, Uh, Uh, Uh, Xue, Xue, Xue, Xue, Xue, Xue, Xue, Uu, Uu, Xue, Xue, Xue, Xue, Xue, Uu, Uu, Xue, Xue, Xue, Xue, Xue, Xue, Xue, Xue, Xue, Xue, Xue, Xue, Xue, Xue, Xue, Uu, Uu, Xue, Xue, Xue, Xue, Xue, Xue, Xue, Xue, Xue, Xue, Xue, Xue, Xue, Xue, Xue, Xue, Xue, Xue, Xue
Uue, Uue, Uue, Uu, Uh, Uh, Uh, Uh, Xue, Xue, Xue, Xue, Xue, Xue, Xue, Xue, Xue, Xue, Xue, Uu, Uu, Uu, Uu, Uu, Xue, Xue, Xue, Xue, Xue, Xue, Xue, Xue, Xue, Xue, Xue, Xue, Xue, Xue, Xue, Xue, Xue, Uu, Uu, Xue, Xue, Xue, Xue, Xue, Xue, Xue, Xue, Xue, Xue, Xue, Xue, Xue, Xue, Xue, Xue, Xue, Xue, Xue
Xue, Xue, Xue, Xue, Xue, Xue, Xue, Xue, Xue, Xue, Xue, Xue, Xue, Xue, Xue, Xue, Xue, Xue, Xue, Uu, Uu, Uu, Xue, Xue, Xue, Xue, Xue, Xue, Xue, Xue, Xue, Xue, Xue, Xue, Xue, Xue, Xue, Xue, Xue, Xue, Xue, Xue, Uu, Xue, Xue, Xue, Xue, Xue, Xue, Xue, Xue, Xue, Xue, Xue, Xue, Xue, Xue, Xue, Uu, Uu, Uu, Uu
Xue, Xue, Xue, Xue, Xue, Xue, Xue, Xue, Xue, Xue, Xue, Xue, Xue, Xue, Xue, Xue, Xue, Xue, Xue, Uu, Uu, Xue, Xue, Xue, Xue, Xue, Xue, Xue, Xue, Xue, Xue, Xue, Xue, Xue, Xue, Xue, Xue, Xue, Xue, Xue, Xue, Xue, Uu, Uu, Xue, Xue, Xue, Xue, Xue, Xue, Xue, Xue, Xue, Xue, Xue, Xue, Uu, Xue, Uu, Uu, Xue, Xue
Xue, Xue, Xue, Xue, Xue, Xue, Xue, Xue, Xue, Xue, Xue, Xue, Xue, Xue, Xue, Xue, Xue, Xue, Xue, Uu, Xue, Xue, Xue, Xue, Xue, Xue, Xue, Xue, Xue, Xue, Xue, Xue, Xue, Xue, Xue, Xue, Xue, Xue, Xue, Xue, Xue, Xue, Uu, Xue, Xue, Xue, Xue, Xue, Xue, Xue, Xue, Xue, Xue, Xue, Uu, Xue, Uu, Uu, Xue, Xue, Gg, Gg
Xue, Xue, Xue, Xue, Xue, Xue, Xue, Xue, Xue, Xue, Xue, Xue, Xue, Xue, Xue, Xue, Xue, Xue, Xue, Uu, Xue, Xue, Xue, Xue, Xue, Xue, Xue, Xue, Xue, Xue, Xue, Xue, Xue, Xue, Xue, Xue, Xue, Xue, Xue, Xue, Xue, Uu, Uu, Xue, Xue, Xue, Xue, Xue, Xue, Xue, Xue, Xue, Uu, Uu, Uu, Uu, Xue, Xue, Gg, Gg, Gg, Gg
Xue, Xue, Xue, Xue, Xue, Xue, Xue, Xue, Xue, Xue, Xue, Xue, Xue, Xue, Xue, Xue, Xue, Xue, Uu, Uu, Xue, Xue, Xue, Xue, Xue, Xue, Xue, Xue, Xue, Xue, Xue, Xue, Xue, Xue, Xue, Xue, Xue, Xue, Xue, Xue, Xue, Xue, Xue, Uu, Uu, Uu, Uu, Xue, Xue, Xue, Uu, Uu, Uu, Uu, Xue, Xue, Gg, Gg, Gg, Gg, Gg, Gg
Xue, Xue, Xue, Xue, Xue, Xue, Xue, Xue, Xue, Xue, Xue, Xue, Xue, Xue, Xue, Xue, Xue, Xue, Uu, Uu, Xue, Xue, Xue, Xue, Xue, Xue, Xue, Xue, Xue, Xue, Xue, Xue, Xue, Xue, Xue, Xue, Xue, Xue, Xue, Xue, Xue, Xue, Uu, Uu, Uu, Uu, Uu, Uu, Uu, Uu, Uu, Uu, Xue, Xue, Gg, Gg, Gg, Gg, Gg, Gg, Gg, Gg
Uu, Xue, Xue, Xue, Xue, Xue, Xue, Xue, Xue, Xue, Xue, Xue, Xue, Xue, Uu, Xue, Uu, Uu, Uu, Xue, Xue, Xue, Xue, Xue, Xue, Xue, Xue, Xue, Uu, Uu, Uu, Xue, Xue, Xue, Xue, Xue, Xue, Xue, Xue, Xue, Xue, Uu, Uu, Uu, Uu, Uu, Uu, Uu, Uu, Uu, Xue, Xue, Gg, Gg, Gg, Gg, Gg, Gg, Gg, Gg, Gg, Gg
Uue, Uu, Uu, Xue, Xue, Xue, Xue, Xue, Xue, Xue, Uu, Uu, Uu, Uu, Uu, Uu, Uu, Uu, Kud, Uu, Uu, Xue, Xue, Xue, Xue, Xue, Uu, Uu, Uu, Uu, Uu, Uu, Uu, Uu, Uu, Xue, Xue, Xue, Xue, Uu, Uu, Uu, Uue, Uue, Uue, Uue, Uue, Uu, Xue, Xue, Gg, Gg, Gg, Gg, Gg, Gg, Gg, Gg, Gg, Gg, Gg, Gg
Uue, Uue, Xue, Uu, Uu, Xue, Uu, Xue, Uu, Xue, Uu, Uu, Xue, Uu, Uu, Uu, Uu, Uu, Uu, Uu, Uu, Uu, Uu, Uu, Uu, Uu, Uu, Uu, Xue, Xue, Xue, Uu, Uu, Uu, Uu, Uu, Uu, Xue, Uu, Uu, Xue, Xue, Xue, Uue, Uue, Uue, Xue, Xue, Gg, Gg, Gg, Gg, Gg, Gg, Gg, Gg, Gg, Gg, Gg, Gg, Gg, Gg
Xue, Xue, Gg, Xue, Xue, Uu, Uu, Uu, Uu, Uu, Xue, Xue, Gg, Xue, Xue, Uu, Uu, Uu, Uu^Ii, Uu, Uu^Ii, Uu, Uu, Uu, Xue, Uu, Xue, Xue, Gg, Gg, Gg, Xue, Xue, Uu, Uu, Uu, Uu, Uu, Xue, Xue, Gg, Gg, Gg, Xue, Xue, Xue, Gg, Gg, Gg, Gg, Gg, Gg, Gg, Gg, Gg, Gg, Gg, Gg, Gg, Gg, Gg, Gg
Gg, Gg, Gg, Gg, Gg, Xue, Xue, Xue, Xue, Xue, Gg, Gg, Gg, Gg, Gg, Xue, Xue, Uu^Ii, Uu^Ii, 1 Uu^Ii, Uu^Ii, Uu^Ii, Xue, Xue, Gg, Xue, Gg, Gg, Gg, Gg, Gg, Gg, Gg, Xue, Xue, Uu, Xue, Xue, Gg, Gg, Gg, Gg, Gg, Gg, Gg, Gg, Gg, Gg, Gg, Gg, Gg, Gg, Gg, Gg, Gg, Gg, Gg, Gg, Gg, Gg, Gg, Gg
Gg, Gg, Gg, Gg, Gg, Gg, Gg, Gg, Gg, Gg, Gg, Gg, Gg, Gg, Gg, Gg, Gg, Xue, Uu^Ii, Uu^Ii, Uu^Ii, Xue, Gg, Gg, Gg, Gg, Gg, Gg, Gg, Gg, Gg, Gg, Gg, Gg, Gg, Xue, Gg, Gg, Gg, Gg, Gg, Gg, Gg, Gg, Gg, Gg, Gg, Gg, Gg, Gg, Gg, Gg, Gg, Gg, Gg, Gg, Gg, Gg, Gg, Gg, Gg, Gg
Gg, Gg, Gg, Gg, Gg, Gg, Gg, Gg, Gg, Gg, Gg, Gg, Gg, Gg, Gg, Gg, Gg, Xue, Uu^Ii, Uu^Ii, Uu^Ii, Xue, Gg, Gg, Gg, Gg, Gg, Gg, Gg, Gg, Gg, Gg, Gg, Gg, Gg, Gg, Gg, Gg, Gg, Gg, Gg, Gg, Gg, Gg, Gg, Gg, Gg, Gg, Gg, Gg, Gg, Gg, Gg, Gg, Gg, Gg, Gg, Gg, Gg, Gg, Gg, Gg
Gg, Gg, Gg, Gg, Gg, Gg, Gg, Gg, Gg, Gg, Gg, Gg, Gg, Gg, Gg, Gg, Gg, Xue, Uu^Ii, Uu^Ii, Uu^Ii, Xue, Gg, Gg, Gg, Gg, Gg, Gg, Gg, Gg, Gg, Gg, Gg, Gg, Gg, Gg, Gg, Gg, Gg, Gg, Gg, Gg, Gg, Gg, Gg, Gg, Gg, Gg, Gg, Gg, Gg, Gg, Gg, Gg, Gg, Gg, Gg, Gg, Gg, Gg, Gg, Gg
