border_size=1
usage=map

Xuc, Xuc, Xuc, Xuc, Xuc, Xuc, Ql, Ql, Ql, Ql, Ql, Ql, Ql, Ql, Ql, Ql, Uu, Uu, Ql, Ql, Ql, Ql, Ql, Ql, Ql, Ql, Ql, Ql, Ql, Xuc, Xuc, Xuc, Xuc, Xuc, Xuc, Xuc, Xuc, Xuc, Xuc, Xuc, Xuc, Xuc, Xuc, Xuc, Xuc, Xuc
Xuc, Xuc, Xuc, Xuc, Xuc, Xuc, Uu^Vu, Ql, Ql, Ql, Ql, Ql, Ql, Ql, Uu^Ecf, Uh, Cud, Uu^Vu, Ql, Ql, Ql, Ql, Ql, Ql, Uu^Vud, Ql, Ql, Ql, Ql, Xuc, Xuc, Xuc, Xuc, Xuc, Xuc, Xuc, Xuc, Xuc, Xuc, Xuc, Xuc, Xuc, Xuc, Xuc, Xuc, Xuc
Xuc, Xuc, Xuc, Xuc, Xuc, Xuc, Xuc, Ur, Ur, Ql, Ql, Ql, Ql, Uu, Uu^Vu, Cud, 3 Kud, Cud, Uh, Cud^Ecf, Ql, Ql, Uu, Uu, Uu, Uu, Ql, Ql, Xuc, Xuc, Xuc, Xuc, Xuc, Xuc, Xuc, Xuc, Xuc, Xuc, Xuc, Xuc, Xuc, Xuc, Xuc, Xuc, Xuc, Xuc
Xuc, Xuc, Xuc, Xuc, Xuc, Xuc, Xuc, Uu^Uf, Ur, Ql, Ql, Ql, Ql, Cud^Ecf, Uh, Cud, Cud, Cud, Uu^Ecf, Uu^Vu, Ql, Ql, Ql, Ql, Ql, Ql, Ql, Ql, Xuc, Xuc, Xuc, Xuc, Xuc, Xuc, Xuc, Xuc, Xuc, Xuc, Xuc, Xuc, Xuc, Xuc, Xuc, Xuc, Xuc, Xuc
Xuc, Xuc, Xuc, Xuc, Xuc, Xuc, Uu^Vu, Uu^Uf, Ur, Uh, Uh, Ql, Ql, Ql, Ql, Uh, Urb, Uu, Ql, Ql, Ql, Ql, Ql, Ql, Ql, Ql, Ql, Xuc, Xuc, Xuc, Xuc, Xuc, Xuc, Xuc, Xuc, Xuc, Xuc, Xuc, Xuc, Xuc, Xuc, Xuc, Xuc, Xuc, Xuc, Xuc
Xuc, Xuc, Xuc, Xuc, Xuc, Xuc, Xuc, Ur, Ur, Uu, Uu, Uu^Vu, Ur, Ql, Ql, Cud^Ecf, Urb, Cud^Ecf, Ql, Ql, Ql, Ql, Uu, Uu^Vu, Xuc, Xuc, Xuc, Xuc, Xuc, Xuc, Xuc, Xuc, Xuc, Xuc, Xuc, Xuc, Xuc, Xuc, Xuc, Xuc, Xuc, Xuc, Xuc, Xuc, Xuc, Xuc
Xuc, Xuc, Xuc, Xuc, Xuc, Xuc, Xuc, Uu^Uf, Ur, Ur, Ur, Uu, Ur, Ql, Ql, Ql, Urb, Ql, Ql, Ql, Uu, Uu, Uh, Xuc, Xuc, Xuc, Xuc, Xuc, Xuc, Xuc, Xuc, Xuc, Xuc, Xuc, Xuc, Xuc, Xuc, Xuc, Xuc, Xuc, Xuc, Xuc, Xuc, Xuc, Xuc, Xuc
Xuc, Xuc, Xuc, Xuc, Xuc, Xuc, Uu^Vu, Ur, Uu, Uu, Uh, Ur, Ur, Uu, Uu, Ql, Urb, Ql, Ql, Ql, Uu, Xuc, Xuc, Xuc, Xuc, Xuc, Xuc, Xuc, Xuc, Xuc, Xuc, Xuc, Xuc, Xuc, Xuc, Xuc, Xuc, Xuc, Xuc, Xuc, Xuc, Xuc, Xuc, Xuc, Xuc, Xuc
Xuc, Xuc, Xuc, Xuc, Xuc, Xuc, Xuc, Uu, Qxu, Uu^Uf, Qxu, Uh, Uh, Ur, Ur, Uh, Ur, Ql, Uu, Uu, Xuc, Xuc, Xuc, Xuc, Xuc, Xuc, Xuc, Xuc, Xuc, Xuc, Xuc, Xuc, Xuc, Xuc, Xuc, Xuc, Xuc, Xuc, Xuc, Xuc, Xuc, Xuc, Xuc, Xuc, Xuc, Xuc
Xuc, Xuc, Xuc, Xuc, Xuc, Xuc, Xuc, Qxu^Bcx|, Qxu, Qxu, Uu, Qxu^Bcx/, Qxu, Uh, Qxu^Bcx|, Qxu, Qxu, Uu, Uu^Vu, Xuc, Xuc, Xuc, Xuc, Xuc, Xuc, Xuc, Xuc, Xuc, Xuc, Xuc, Xuc, Xuc, Xuc, Xuc, Xuc, Xuc, Xuc, Xuc, Xuc, Xuc, Xuc, Xuc, Xuc, Xuc, Xuc, Xuc
Xuc, Xuc, Xuc, Xuc, Xuc, Xuc, Xuc, Uu, Uu, Uu, Uu, Uu, Uu, Qxu, Uu, Qxu, Xuc, Xuc, Xuc, Xuc, Xuc, Xuc, Xuc, Xuc, Xuc, Xuc, Xuc, Xuc, Xuc, Xuc, Xuc, Xuc, Xuc, Xuc, Xuc, Xuc, Xuc, Xuc, Xuc, Xuc, Xuc, Xuc, Xuc, Xuc, Xuc, Xuc
Xuc, Xuc, Xuc, Xuc, Xuc, Xuc, Uh, Uu, Uu, Uu, Cud, Uu^Vu, Uu, Ur, Xuc, Xuc, Xuc, Xuc, Xuc, Xuc, Xuc, Xuc, Xuc, Xuc, Xuc, Xuc, Xuc, Xuc, Xuc, Xuc, Xuc, Xuc, Xuc, Xuc, Xuc, Xuc, Xuc, Xuc, Xuc, Xuc, Xuc, Xuc, Xuc, Xuc, Xuc, Xuc
Xuc, Xuc, Xuc, Xuc, Xuc, Xuc, Uh, Uu, Uu^Vu, Cud, Kud, Cud, Ur, Ur, Uu^Uf, Uh, Uh, Uh, Uh, Uh^Emf, Uh, Xuc, Xuc, Xuc, Xuc, Xuc, Xuc, Xuc, Xuc, Xuc, Xuc, Xuc, Xuc, Xuc, Xuc, Xuc, Xuc, Xuc, Xuc, Xuc, Xuc, Xuc, Xuc, Xuc, Xuc, Xuc
Xuc, Xuc, Xuc, Xuc, Xuc, Xuc, Uh, Uu, Uu, Cud, Cud, Cud, Uu, Ur, Ur, Uu^Uf, Uu, Uu, Uu, Uh, Uu^Uf, Xuc, Xuc, Xuc, Xuc, Xuc, Xuc, Xuc, Xuc, Xuc, Xuc, Xuc, Xuc, Xuc, Xuc, Xuc, Xuc, Xuc, Xuc, Xuc, Xuc, Xuc, Xuc, Xuc, Xuc, Xuc
Xuc, Xuc, Xuc, Xuc, Xuc, Xuc, Xuc, Uh, Uh, Uu, Uh, Uu^Vu, Uu, Uu, Uu, Ur, Ur, Ur, Ur, Ur, Ur, Uu^Uf, Xuc, Xuc, Xuc, Xuc, Xuc, Xuc, Xuc, Xuc, Xuc, Xuc, Xuc, Xuc, Xuc, Xuc, Xuc, Xuc, Xuc, Xuc, Xuc, Xuc, Xuc, Xuc, Xuc, Xuc
Xuc, Xuc, Xuc, Xuc, Xuc, Xuc, Xuc, Xuc, Xuc, Xuc, Xuc, Uu, Uh, Uu, Uh, Uu, Uu^Uf, Uu^Emf, Uu^Uf, Uu^Emf, Xuc, Ur, Ur, Xuc, Xuc, Xuc, Xuc, Xuc, Xuc, Xuc, Xuc, Xuc, Xuc, Xuc, Xuc, Xuc, Xuc, Xuc, Xuc, Xuc, Xuc, Xuc, Xuc, Xuc, Xuc, Xuc
Xuc, Xuc, Xuc, Xuc, Xuc, Xuc, Xuc, Xuc, Xuc, Xuc, Xuc, Xuc, Xuc, Xuc, Xuc, Uu^Emf, Xuc, Uu^Uf, Xuc, Xuc, Xuc, Xuc, Uu^Uf, Ur, Xuc, Xuc, Xuc, Xuc, Xuc, Xuc, Xuc, Xuc, Xuc, Xuc, Xuc, Xuc, Xuc, Xuc, Xuc, Xuc, Xuc, Xuc, Xuc, Xuc, Xuc, Xuc
Hh^Fms, Xuc, Hh^Fms, Xuc, Hh, Xuc, Xuc, Xuc, Xuc, Xuc, Xuc, Xuc, Xuc, Xuc, Xuc, Xuc, Xuc, Xuc, Xuc, Xuc, Xuc, Xuc, Uh^Emf, Ur, Xuc, Xuc, Mm^Xm, Mm^Xm, Mm^Xm, Xuc, Xuc, Xuc, Xuc, Xuc, Xuc, Xuc, Xuc, Xuc, Xuc, Xuc, Xuc, Xuc, Xuc, Xuc, Xuc, Xuc
Hh^Fms, Hh^Fms, Hh^Fms, Hh^Fms, Hh, Hh, Hh, Xuc, Mm, Xuc, Xuc, Xuc, Xuc, Xuc, Xuc, Xuc, Xuc, Xuc, Xuc, Xuc, Xuc, Xuc, Xuc, Ur^Ii, Xuc, Xuc, Mm^Xm, Mm^Xm, Mm^Xm, Mm^Xm, Mm^Xm, Mm^Xm, Mm, Xuc, Xuc, Xuc, Xuc, Xuc, Xuc, Xuc, Xuc, Xuc, Xuc, Xuc, Xuc, Xuc
Hh^Fms, Hh^Fms, Hh^Fms, Hh^Fms, Hh^Fms, Hh, Hh, Mm, Mm, Mm^Xm, Mm^Xm, Xuc, Mm^Xm, Xuc, Xuc, Xuc, Mm^Xm, Xuc, Mm^Xm, Xuc, Mm^Xm, Xuc, Mm^Xm, Hh, Mm^Xm, Mm^Xm, Mm^Xm, Mm^Xm, Mm, Mm, Mm, Mm, Mm, Mm^Xm, Mm^Xm, Xuc, Xuc, Xuc, Xuc, Xuc, Xuc, Xuc, Xuc, Xuc, Xuc, Xuc
Gs^Fms, Hh^Fms, Hh^Fms, Hh^Fms, Hh^Fms, Hh, Hh, Hh, Mm, Mm, Mm, Mm^Xm, Mm^Xm, Mm^Xm, Mm^Xm, Mm^Xm, Mm^Xm, Mm^Xm, Mm, Mm^Xm, Mm^Xm, Mm^Xm, Mm^Xm, Hh, Mm^Xm, Mm^Xm, Mm^Xm, Mm, Mm, Mm, Mm, Mm, Mm, Mm, Mm, Mm, Mm, Hh^Fms, Hh, Hh^Fms, Gs^Fms, Gs^Fms, Gs^Fms, Gs^Fms, Gs^Fms, Gs^Fms
Gs^Fms, Gs^Fms, Gs^Fms, Hh^Fms, Hh^Fms, Hh, Mm, Hh, Hh, Mm, Mm, Mm, Mm, Mm^Xm, Mm, Mm, Mm^Xm, Mm, Mm, Mm, Mm, Mm^Xm, Mm, Hh, Hh, Mm^Xm, Mm, Mm, Mm, Mm, Hh, Hh, Hh, Hh, Mm, Mm, Hh, Hh, Gs^Fms, Gs^Fms, Gs^Fms, Gs^Fms, Gg^Efm, Gs^Fms, Gs^Fms, Gs^Fms
Gs^Fms, Gs^Fms, Gs^Fms, Gs^Fms, Hh^Fms, Hh^Fms, Hh, Hh, Hh, Mm, Hh, Mm, Mm, Mm, Mm, Mm, Hh, Hh, Hh, Mm, Hh, Mm, Mm, Mm, Hh, Mm, Hh, Hh, Hh, Hh, Hh^Fms, Hh, Hh, Hh, Hh, Hh, Hh, Hh^Fms, Gg^Efm, Gs^Fms, Hh^Fms, Hh^Fms, Gs^Fms, Gs^Fms, Gs^Fms, Gs^Fms
Gs^Fms, Gs^Fms, Gs^Fms, Gs^Fms, Hh^Fms, Hh^Fms, Hh^Fms, Hh, Hh, Hh, Hh, Hh, Hh, Hh, Hh, Hh, Hh, Hh, Hh, Hh, Gg^Eff, Hh, Hh, Hh, Re, Hh, Gg, Hh^Fms, Hh^Fms, Hh^Fms, Hh^Fms, Hh^Fms, Hh^Fms, Hh, Hh, Hh^Fms, Hh, Hh^Fms, Hh, Hh^Fms, Gs^Fms, Gs^Fms, Gs^Fms, Gs^Fms, Gs^Fms, Gs^Fms
Gs^Fms, Gs^Fms, Gs^Fms, Gs^Fms, Hh^Fms, Hh^Fms, Hh^Fms, Hh^Fms, Hh^Fms, Hh, Hh^Fms, Hh, Hh^Fms, Hh, Hh^Fms, Gg, Gg, Gg, Gg^Eff, Gg^Eff, Gg^Gvs, Gg^Eff, Gg^Vwm, Gg, Rp, Gg, Gg, Gg, Gg, Gg, Gg, Hh^Fms, Hh^Fms, Hh, Hh^Fms, Hh, Hh^Fms, Hh^Fms, Gs^Vl, Hh^Fms, Hh^Fms, Hh^Fms, Gs^Fms, Gs^Fms, Gs^Vl, Gs^Fms
Gs^Fms, Gs^Fms, Gs^Fms, Gs^Fms, Gs^Fms, Gs^Fms, Gs^Fms, Hh^Fms, Hh^Fms, Hh^Fms, Gs^Fms, Hh^Fms, Hh^Fms, Hh^Fms, Gg, Gg, Gg, Gg^Eff, Gg^Gvs, Gg^Gvs, Gg^Gvs, Gg^Gvs, Gg^Gvs, Gg, Rp, Gg, Rp, Gs^Vh, Gg, Gg, Hh^Fms, Hh^Fms, Hh^Fms, Hh^Fms, Hh^Fms, Hh^Fms, Gs^Fms, Gs^Fms, Gs^Fms, Gs^Fms, Gs^Fms, Gs^Fms, Gs^Fms, Gs^Fms, Gs^Fms, Gs^Fms
Gs^Fms, Gs^Fms, Gs^Fms, Gs^Fms, Gs^Fms, Gs^Fms, Gs^Fms, Gs^Fms, Gs^Fms, Gs^Fms, Gs^Fms, Hh^Fms, Gg, Gg, Gg, Gg, Gg, Gg, Gg, Gg^Gvs, Gg^Gvs, Gg^Gvs, Gg, Rr, Gg, Rr, Gg, Gg, Gg, Gg, Gg, Hh^Fms, Hh^Fms, Hh^Fms, Gg^Efm, Gs^Fms, Gs^Fms, Gs^Fms, Gs^Fms, Gs^Fms, Gs^Fms, Gg^Efm, Gg^Efm, Gs^Fms, Gs^Fms, Gs^Fms
Gs^Fms, Gs^Fms, Gs^Fms, Gs^Fms, Gs^Fms, Gs^Fms, Gs^Fms, Gs^Fms, Gs^Fms, Gs^Fms, Hh^Fms, Gg, Gg, Gg, Gg, Gg, Gg, Gg, Gg, Gg, 1 Gg, Gs^Vh, Rr, Rr, Gg, Rr, Gs^Vh, Gg, Gg, Gg, Gs^Vl, Gg, Gs^Fms, Gs^Fms, Gs^Fms, Gg^Efm, Gs^Fms, Gs^Fms, Gs^Fms, Gs^Fms, Gs^Fms, Gs^Fms, Gs^Fms, Gs^Fms, Gs^Fms, Gs^Fms
Gs^Fms, Gs^Fms, Gg, Gs^Fms, Gs^Fms, Gs^Fms, Gs^Fms, Gs^Fms, Gs^Fms, Gs^Fms, Gs^Fms, Gg, Gg, Gg, Gg, Gg, Gg, Gg, Gg^Eff, Gg, Gg, Gg, Ch, Ch, Ch, Rr, Rr, Rp, Rp, Rp, Gs^Fms, Gs^Fms, Gs^Fms, Gs^Fms, Gs^Fms, Gs^Fms, Gs^Fms, Gs^Fms, Gs^Fms, Gs^Fms, Gs^Fms, Gs^Fms, Gs^Fms, Gs^Fms, Gs^Fms, Gs^Fms
Gs^Fms, Gs^Fms, Gs^Fms, Gs^Fms, Gs^Fms, Gs^Fms, Gs^Fms, Gs^Fms, Gs^Fms, Gg, Gs^Fms, Gg, Gg, Gg, Gg, Gg, Gg^Eff, Gg^Eff, Gg^Gvs, Gg, Gg^Vwm, Gg, Ch, 2 Kh, Ch, Gg, Rr, Gg, Gg, Gs^Fms, Gs^Fms, Gs^Fms, Gs^Fms, Gs^Fms, Gs^Fms, Gs^Fms, Gs^Fms, Gs^Fms, Gg^Efm, Gs^Fms, Gs^Fms, Gs^Fms, Gs^Fms, Gs^Fms, Gg^Efm, Gs^Fms
Gs^Fms, Gs^Fms, Gs^Fms, Gs^Fms, Gs^Fms, Gs^Fms, Gs^Fms, Gs^Fms, Gs^Fms, Gg, Gg, Gs^Fms, Gg, Gg, Gg^Eff, Gg^Eff, Gg^Gvs, Gg^Gvs, Gg^Gvs, Gg^Gvs, Gg^Gvs, Gg, Rr, Ch, Gg, Gg, Rr, Gg, Gg, Gs^Fms, Gs^Fms, Gs^Fms, Gs^Fms, Gs^Fms, Gs^Fms, Gs^Fms, Gs^Fms, Gg^Efm, Gs^Fms, Gg^Efm, Gs^Fms, Gs^Fms, Gs^Fms, Gs^Fms, Gs^Fms, Gs^Fms
Gs^Fms, Gs^Fms, Gs^Fms, Gs^Fms, Gs^Fms, Gs^Fms, Gs^Fms, Gs^Fms, Gs^Fms, Gs^Fms, Gg, Gs^Fms, Gs^Fms, Gg, Gg, Gg^Eff, Gg^Eff, Gg^Gvs, Gg^Gvs, Gg^Gvs, Gg, Gg, Gs^Vh, Rr, Rr, Rr, Gg, Rp, Gs^Vl, Gs^Fms, Gs^Fms, Gg, Gs^Fms, Gs^Fms, Gs^Fms, Gs^Fms, Gs^Fms, Gs^Fms, Gs^Fms, Gs^Fms, Gs^Fms, Gs^Fms, Gs^Fms, Gs^Fms, Gs^Fms, Gs^Fms
Gs^Fms, Gs^Fms, Gs^Fms, Gs^Fms, Gs^Fms, Gs^Fms, Gs^Fms, Gs^Fms, Gs^Fms, Gs^Fms, Gs^Fms, Gg, Gs^Fms, Gg, Gg, Gg, Gg, Gg^Eff, Gg, Gg, Gg, Gg, Gg, Gg, Gg, Gs^Vh, Gg, Gg, Gg, Gs^Fms, Gs^Fms, Gs^Fms, Gs^Fms, Gs^Fms, Gs^Fms, Gs^Fms, Gs^Fms, Gs^Fms, Gg^Efm, Gs^Fms, Gs^Fms, Gs^Fms, Gs^Fms, Gs^Fms, Gs^Fms, Gs^Fms
Gs^Fms, Gs^Fms, Gs^Fms, Gs^Fms, Gs^Fms, Gs^Fms, Gs^Fms, Gs^Fms, Gs^Fms, Gs^Fms, Gs^Fms, Gs^Fms, Gs^Fms, Gg, Gg, Gg, Gg, Gg, Gg, Gg, Gg, Gg, Gg, Gg, Gg, Gg, Gg, Gg, Gg, Gg, Gg^Efm, Gs^Fms, Gg^Efm, Gg^Efm, Gg^Efm, Gs^Fms, Gs^Fms, Gs^Fms, Gs^Fms, Gs^Fms, Gs^Fms, Gs^Fms, Gs^Fms, Gs^Fms, Gs^Fms, Gs^Fms
Gs^Fms, Gs^Fms, Gs^Fms, Gs^Fms, Gs^Fms, Gs^Fms, Gs^Fms, Gs^Fms, Gg, Gs^Fms, Gs^Fms, Gs^Fms, Gg, Gs^Fms, Gg, Gg, Gg, Gg, Gg, Gg, Gg, Gg, Gg, Gg, Gg, Gg, Gg, Gg, Gg, Gs^Fms, Gs^Fms, Gs^Fms, Gs^Fms, Gs^Efm, Gs^Fms, Gs^Fms, Gs^Fms, Gs^Fms, Gs^Fms, Gs^Fms, Gs^Fms, Gs^Fms, Gs^Fms, Gs^Fms, Gs^Fms, Gs^Fms
