border_size=1
usage=map

Gg, Gg, Gg, Gg, Xos, Xos, Xos, Gg, Gg, Gg, Gg
Gg, Gg, Xos, Xos, Ch, Ch, Ch, Xos, Xos, Gg, Gg
Xos^Efs, Xos, Ch, Ch, Ch, Ch, Ch, Ch, Ch, Xos, Xos
Xos^Efs, Ch, Ch, Ch, Ch, 2 Ch, Ch, Ch, Ch, Ch, Xos
Xos^Efs, Ch, Ch, Ch, Ch, Ch, Ch, Ch, Ch, Ch, Xos
Xos^Efs, Ch, Ch, Ch, Ch, Ch, Ch, Ch, Ch, Ch, Xos
Xos^Efs, Ch, Ch, Ch, Ch, Ch, Ch, Ch, Ch, Ch, Xos
Xos^Efs, Ch, Ch, Ch, Ch, Ch, Ch, Ch, Ch, Ch, Xos
Xos^Efs, Ch, Ch, Ch, Ch, Ch, Ch, Ch, Ch, Ch, Xos
Xos^Efs, Ch, Ch, Ch, Ch, Ch, Ch, Ch, Ch, Ch, Xos
Xos^Efs, Ch, Ch, Ch, Ch, Ch, Ch, Ch, Ch, Ch, Xos
Xos^Efs, Ch, Ch, Ch, Ch, Ch, Ch, Ch, Ch, Ch, Xos
Xos^Efs, Ch, Ch, Ch, Ch, Ch, Ch, Ch, Ch, Ch, Xos
Xos^Efs, Ch, Ch, Ch, Ch, Ch, Ch, Ch, Ch, Ch, Xos
Xos^Efs, Ch, Ch, Ch, Ch, Ch, Ch, Ch, Ch, Ch, Xos
Xos^Efs, Ch, Ch, Ch, Ch, Ch, Ch, Ch, Ch, Ch, Xos
Xos^Efs, Ch, Ch, Ch, Xos^Efs, Ch, Xos, Ch, Ch, Ch, Xos
Xos^Efs, Ch, Xos^Efs, Xos^Efs, Ch, Ch, Ch, Xos, Xos, Ch, Xos
Gg, Xos^Efs, Gg, Ch, Ch, Ch, Ch, Ch, Gg, Xos, Gg
Gg, Gg, Gg, Gg, Gg, Gg, Gg, Gg, Gg, Gg, Gg
Gg, Gg, Gg, Gg, Gg, Gg, Gg, Gg, Gg, 1 Gg, Gg
Gg, Gg, Gg, Gg, Gg, Gg, Gg, Gg, Gg, Gg, Gg
