border_size=1
usage=map

Gg, Gg, Gg, Gg, Xos, Xos, Xos, Gg, Gg, Gg, Gg
Gg, Gg, Xos, Xos, Ch, Ch, Ch, Xos, Xos, Gg, Gg
Xol, Xos, Ch, Ch, Ch, Ch, Ch, Ch, Ch, Xos, Xos
Xol, Ch, Ch, Ch, Ch, 2 Ch, Ch, Ch, Ch, Ch, Xos
Xol, Ch, Ch, Ch, Ch, Ch, Ch, Ch, Ch, Ch, Xos
Xol, Ch, Ch, Ch, Ch, Ch, Ch, Ch, Ch, Ch, Xos
Xol, Ch, Ch, Ch, Ch, Ch, Ch, Ch, Ch, Ch, Xos
Xol, Ch, Ch, Ch, Ch, Ch, Ch, Ch, Ch, Ch, Xos
Xol, Ch, Ch, Ch, Ch, Ch, Ch, Ch, Ch, Ch, Xos
Xol, Ch, Ch, Ch, Ch, Ch, Ch, Ch, Ch, Ch, Xos
Xol, Ch, Ch, Ch, Ch, Ch, Ch, Ch, Ch, Ch, Xos
Xol, Ch, Ch, Ch, Ch, Ch, Ch, Ch, Ch, Ch, Xos
Xol, Ch, Ch, Ch, Ch, Ch, Ch, Ch, Ch, Ch, Xos
Xol, Ch, Ch, Ch, Ch, Ch, Ch, Ch, Ch, Ch, Xos
Xol, Ch, Ch, Ch, Ch, Ch, Ch, Ch, Ch, Ch, Xos
Xol, Ch, Ch, Ch, Ch, Ch, Ch, Ch, Ch, Ch, Xos
Xol, Ch, Ch, Ch, Xol, Ch, Xos, Ch, Ch, Ch, Xos
Xol, Ch, Xol, Xol, Ch, Ch, Ch, Xos, Xos, Ch, Xos
Gg, Xol, Gg, Ch, Ch, Ch, Ch, Ch, Gg, Xos, Gg
Gg, Gg, Gg, Gg, Gg, Gg, Gg, Gg, Gg, Gg, Gg
Gg, Gg, Gg, Gg, Gg, Gg, Gg, Gg, Gg, 1 Gg, Gg
Gg, Gg, Gg, Gg, Gg, Gg, Gg, Gg, Gg, Gg, Gg
