border_size=1
usage=map

Mm, Mm, Mm, Mm, Mm, Mm, Mm, Mm, Mm, Mm, Mm, Mm, Hh, Hh, Hh, Re, Hh, Hh, Mm, Mm, Mm, Mm, Mm, Mm, Mm, Mm, Re, Mm, Mm, Mm, Mm, Mm, Mm, Mm, Mm, Mm, Hh, Hh, Hh, Hh, Hh, Mm, Mm, Mm, Mm, Mm, Mm, Mm, Mm, Mm, Mm, Mm, Mm, Mm, Mm, Mm, Mm
Mm, Mm, Mm, Mm, Mm, Mm, Mm, Mm, Mm, Mm, Mm, Mm, Hh, Hh, Hh, Re, Hh, Hh, Mm, Mm, Mm, Mm, Mm, Mm, Mm, Mm, Re, Mm, Mm, Mm, Mm, Mm, Mm, Mm, Mm, Mm, Hh, Hh, Hh, Hh, Mm, Mm, Mm, Mm, Mm, Mm, Mm, Mm, Mm, Mm, Mm, Mm, Mm, Mm, Mm, Mm, Mm
Mm, Mm, Mm, Mm, Mm, Mm, Mm, Mm, Mm, Mm, Mm, Mm, Hh, Hh, Hh, Re, Hh, Hh, Mm, Mm, Mm, Mm, Mm, Mm, Mm, Mm, Re, Mm, Mm, Mm, Mm, Mm, Mm, Mm, Mm, Mm, Hh, Hh, Ce, Hh, Hh, Mm, Mm, Mm, Mm, Mm, Mm, Mm, Mm, Mm, Mm, Mm, Mm, Mm, Mm, Mm, Mm
Mm, Mm, Mm, Mm, Mm, Mm, Mm, Mm, Mm, Mm, Mm, Hh, Hh, Hh, Hh, Re, Hh, Hh, Mm, Mm, Mm, Mm, Mm, Mm, Hh, Hh, Re, Mm, Mm, Mm, Mm, Mm, Mm, Mm, Mm, Hh, Hh, Hh, Hh, Hh, Hh, Mm, Mm, Mm, Mm, Mm, Mm, Mm, Mm, Mm, Mm, Mm, Mm, Mm, Mm, Mm, Mm
Hh, Mm, Mm, Mm, Mm, Mm, Mm, Mm, Mm, Mm, Hh, Hh, Hh, Hh, Re, Rb, Rb, Hh, Hh, Mm, Mm, Mm, Mm, Mm, Hh, Hh, Re, Mm, Mm, Mm, Mm, Mm, Mm, Mm, Hh, Hh, Re, Rb, Rb, Hh, Hh, Hh, Hh, Mm, Mm, Mm, Mm, Mm, Mm, Mm, Mm, Mm, Mm, Mm, Mm, Mm, Mm
Ww, Hh, Hh, Hh, Hh, Hh, Hh, Hh, Hh, Hh, Hh, Hh, Re, Re, Hh, Hh, Hh, Re, Re, Hh, Hh, Hh^Vhh, Hh, Hh, Hh, Hh, Re, Hh, Hh, Hh^Vhh, Hh, Hh, Hh, Hh, Re, Re, Gg, Gs, Gs, Re, Re, Hh, Hh, Hh, Mm, Mm, Hh, Mm, Hh, Mm, Mm, Mm, Mm, Mm, Mm, Mm, Mm
Wwf, Ww, Ww, Hh, Hh, Hh, Hh, Ce, Gs, Hh, Re, Re, Hh, Hh, Hh^Fp, Hh^Fp, Hh^Fp, Hh, Gll^Fp, Re, Re, Hh, Hh, Hh, Rb, Rb, Hh, Hh, Hh, Hh, Hh, Hh, Hh, Hh, Gs, Gg^Es, Gg, Gg, Ce, Gs, Gd, Re, Re, Hh, Hh, Mm, Hh, Hh, Hh, Hh, Hh, Mm, Hh, Mm, Hh, Mm, Hh
Hh, Ww, Ww, Wwf, Ww, Gs, Gs, Gs, Rb, Re, Gs^Es, Gd, Gll, Hh, Gll^Fmw, Hh^Fp, Gg^Fmw, Gs^Fp, Gg^Fp, Gll^Fp, Gll^Fp, Re, Re, Re, Gd, Gd, Gs^Eff, Hh, Gs, Gs, Gs, Hh, Gs, Re, Gll, Gs, Gll^Fp, Gs, Gll^Fp, Gd, Gd, Gd, Re, Hh, Hh, Hh, Hh, Hh, Hh, Hh, Hh, Hh, Hh, Hh, Hh, Hh, Hh
Hh, Hh, Hh, Ww, Ww, Ww, Ww, Rb, Gg, Gs, Ce, Gd, Gll, Gll^Fp, Gll^Fp, Gll^Fmw, Gll^Fmw, Gll^Fmw, Gll^Fmw, Gll^Fp, Gll^Fp, Gll^Vc, Re, Re, Gg, Gg^Es, Gg, Gg^Eff, Gd^Eff, Gg, Gg^Es, Gg, Re, Re, Re, Gll^Fp, Gll^Fmw, Gll^Fmw, Gll^Fp, Gll^Fp, Gg, Gg^Es, Gs, Re, Re, Re, Rb, Hh, Hh, Hh, Hh, Hh, Ww, Ww, Ww, Ww, Ww
Hh, Hh, Hh, Hh, Gs^Eff, Ww, Ww, Ww, Ww, Gg, Ds, Gs, Ww, Gll^Fp, Gll^Fp, Gll^Fp, Gll^Fp, Gll^Fp, Gg^Fp, Gll^Fmw, Gll^Fp, Gll, Re, Gs, Re, Gs, Gd, Gd^Eff, Re, Re, Re, Re, Gll, Gll, Gll^Fp, Gll^Fp, Gll^Fmw, Gll^Fmw, Gll^Fp, Gll^Fp, Gll, Gs^Vl, Gg^Eff, Gg, Ds, Gg^Es, Gg, Rb, Hh, Hh, Ww, Ww, Wo, Wo, Wo, Wo, Ww
Re, Hh, Gg^Eff, Gd^Eff, Gd, Gg^Eff, Gg^Eff, Ww, Ww, Ww, Ww, Ww, Ww, Ww, Ww, Ss^Fp, Ss, Gll^Fp, Gll^Fp, Gll^Fmw, Gll^Fp, Gll^Fp, Re, Re, Gs, Re, Gs, Re, Hh, Gs, Hh^Fp, Gs, Gll^Fp, Gll^Fp, Gg^Fp, Gll^Fp, Gll^Fp, Gll^Fmw, Gll^Fp, Gll^Fp, Gll, Gg^Eff, Ww, Ww, Ww, Ww, Ww, Wwf, Ww, Ww, Ww, Ww, Ww, Wwf, Wwf, Ww, Hh
Gs, Re, Rb, Gs, Gs, Ce, Gs^Es, Gg, Ww, Ww, Ww, Ww, Wo, Ww, Wo, Ww, Ww, Ss^Fp, Ss, Ss, Gll^Fp, Gll^Fp, Re, Gs^Es, Hh, Hh, Hh, Hh, Hh, Hh^Fp, Hh^Fp, Gll^Fp, Gll^Fp, Gs^Fmw, Gs^Fmw, Gg^Fp, Gll^Fp, Gg^Fp, Ss, Ss, Ww, Ww, Wo, Ww, Ww, Ww, Ww, Wo, Ww, Wo, Ww, Ww, Hh, Hh, Hh, Hh, Hh
Gs, Gd^Vh, Gs, Rb, Re, Gs, Gs, Gg, Gg, Ww, Ww, Ww, Ww, Wo, Wo, Wo, Ww, Ww, Ww, Ww, Ww, Gs, Rb, Gs, Hh, Hh, Hh, Hh, Ww, Hh^Fp, Hh^Fp, Gll^Fp, Gs^Fp, Gs^Fp, Gll^Fp, Gll^Fp, Gll^Fp, Gll^Fp, Ww, Ww, Wo, Wo, Ww, Ww, Gg, Ww, Ww, Wwf, Wwf, Ww, Hh, Hh, Hh, Hh, Hh, Hh, Hh
Gs, Gd, Re, Re, Gd, Re, Re, Gg^Vhh, Gs, Gs, Gs, Ds, Gs^Eff, Ww, Ww, Ww, Ds, Ww, Ww, Wo, Ww, Gg, Rb, Gg, Gg, Hh, Ww, Ww, Ww, Ww, Ww, Ss, Ss, Gll^Fp, Ss^Fp, Gll^Fp, Ww, Ww, Wo, Ww, Ww, Ww, Gd^Gvs, Gg^Gvs, Gg^Gvs, Gs, Gs, Gs, Hh, Hh, Hh, Hh, Mm, Mm, Mm, Mm, Mm
Re, Re, Gd^Es, Gd, Gd^Gvs, Gs^Gvs, Gg^Gvs, Re, Re, Re, Re, Gs, Gs, Gg^Eff, Gg, Gs, Gg, Gs, Gg, Ww, Ww, Ww, Wwf, Gg, Ww, Ww, Wo, Wo, Ww, Wo, Wo, Ww, Ww, Gll^Fp, Ww, Ww, Wo, Wo, Ww, Ww, Gg^Gvs, Gd^Gvs, Gd^Gvs, Gs^Gvs, Gs^Es, Gg, Gg, Gs, Hh, Hh, Hh, Mm, Mm, Mm, Mm, Mm, Mm
Gs, Gs, Gg, Gd^Gvs, Gg^Gvs, Gs^Gvs, Gs^Es, Gs, Gg, Gg, Gs, Re, Re, Gg, Gs, Gg^Es, Gd^Gvs, Gg^Gvs, Gs^Gvs, Gg, Gg, Ww, Wwf, Ww, Ww, Ww, Ww, Ww, Gs, Ww, Ww, Wo, Ww, Ww, Ww, Ww, Ww, Ww, Gs, Gs, Gs, Gd^Gvs, Gs, Gd, Gd^Eff, Gs, Gs, Gs, Hh, Ce, Hh, Mm, Mm, Mm, Mm, Mm, Mm
Gs, Gg, Gs, Gg^Vl, Gs, Ce, Gs, Gs, Gs, Gs, Re, Re, Gd, Re, Re, Gd, Gd, Gg^Gvs, Gg^Gvs, Gs^Gvs, Gs, Gs, Re, Ww, Gs^Eff, Ww, Gs^Eff, Gs, Gg^Es, Gg, Gg, Ww, Ww, Ww, Ww, Ww, Gg, Gg, Rb, Rb, Rb, Gs, Gs^Eff, Gg^Eff, Gg, Gg^Eff, Gs, Gg, Hh, Hh, Hh, Hh, Hh, Mm, Mm, Mm, Mm
Gs, Gs, Gg, Gg, Gs, Gs, Gll^Fp, Gs, Re, Re, Gs, Gd^Es, Gll^Fp, Gs, Gs, Re, Re, Gs, Gs, Gs^Es, Gg^Eff, Gs^Eff, Re, Gs, Gg, Gg^Eff, Gg, Gs^Eff, Re, Re, Re, Gg, Gs, Ds, Gg, Gg, Re, Re, Gs, Gs, Gs^Eff, Re, Re, Gg, Gg, Gg^Vc, Gs, Gs, Re, Re, Re, Hh, Hh, Hh, Hh, Mm, Hh
Gll^Fp, Gll, Gll, Gll, Gll, Gs, Gll^Fp, Gll^Fp, Gll^Fp, Gll^Fp, Gll^Fp, Gll^Fp, Gll^Fp, Gll^Fp, Gll^Fp, Gs, Gll^Fp, Re, Re, Gs, Gs, Gs, Gs^Vc, Re, Gs, Gg^Vh, Re, Re, Gll^Fp, Gll^Fp, Gll^Fp, Re, Re, Re, Re, Re, Gs^Es, Gg, Gg^Eff, Gs^Eff, Gg^Es, Gs, Gg, Re, Re, Gs, Rb, Rb, Hh, Hh, Hh, Re, Rb, Hh, Hh, Hh, Hh
Gll^Fp, Gll^Fp, Gs^Fp, Gll^Fp, Gll^Fp, Gll^Fp, Gll^Fp, Gll^Fp, Gll^Fp, Gll^Fp, Gg^Fp, Gs^Fp, Gg^Fp, Gs^Fp, Gs^Fp, Gll^Fp, Gll^Fp, Gll^Fp, Gll, Re, Re, Re, Re, Re, Re, Re, Gd^Gvs, Gd^Gvs, Gd, Gll^Fp, Gll^Fp, Gs, Gll, Gll, Gll^Fp, Gs, Gll^Fp, Gs, Gs, Gg^Eff, Gs, Gg, Gg, Gg^Vh, Gs, Re, Gs, Gs, Gs, Ce, Hh, Hh, Hh, Rb, Re, Re, Re
Gll^Fp, Gs^Fp, Gs^Fmw, Gs^Fp, Gll^Fp, Gll^Fmw, Gll^Fmw, Gll^Fp, Gll^Fp, Gll^Fp, Gs^Fmw, Gg^Fmw, Gs^Fp, Gg^Fp, Gg^Fmw, Gll^Fp, Gll^Fp, Gll^Fp, Gll^Fp, Gll, Gll, Gs, Gg^Es, Re, Re, Gs^Gvs, Gd^Gvs, Gd^Gvs, Gll^Fp, Gll^Fp, Gll^Fmw, Gll^Fp, Gll^Fp, Gll^Fp, Gll^Fp, Gll^Fp, Gll^Fp, Gs, Gs, Gs, Gs, Gs, Gd^Gvs, Gd^Gvs, Gs^Gvs, Re, Gd, Gg^Vh, Gg, Gs^Es, Gs, Hh, Hh, Hh, Hh, Hh, Hh^Fp
Gll^Fp, Gs^Fdw, Gs^Fp, Gs^Fp, Gll^Fp, Gll^Fmw, Gs^Fp, Gll^Fp, Gll^Fp, Gll^Fdw, Gll^Fp, Gs^Fmw, Gs^Fp, Gs^Fp, Gll^Fmw, Gll^Fmw, Gll^Fp, Gll^Fp, Gll^Fp, Gll^Fp, Gll^Fp, Gll, Gll, Gg, Re, Gs^Vc, Gs, Gll^Fp, Gll^Fmw, Gll^Fmw, Gg^Fmw, Gll^Fp, Gg^Fp, Gll^Fmw, Gll^Fmw, Gll^Fp, Gll^Fp, Gll^Fp, Gll, Gll, Gg^Vl, Gg, Gg, Gs^Gvs, Gs, Re, Gs, Gd, Gll^Vl, Gs, Gll^Fp, Hh, Hh^Fp, Hh^Fp, Gll^Fp, Hh^Fp, Hh^Fp
Gll^Fp, Gll^Fp, Gll^Fp, Gll^Fp, Gg^Fp, Gs^Fp, Gs^Fp, Gs^Fp, Gg^Fp, Gll^Fp, Gg^Fp, Gll^Fp, Gll^Fp, Gll^Fp, Gll^Fmw, Gll^Fp, Gll^Fp, Gll^Fp, Gll^Fp, Gll^Fp, Gll^Fp, Gll^Fp, Gll^Fp, Gg, Gs, Re, Gs, Gll^Fp, Gll^Fp, Gll^Fp, Gg^Fp, Gg^Fp, Gg^Fp, Gll^Fp, Gg^Fmw, Gll^Fmw, Gll^Fp, Gll^Fp, Gll, Gll, Gll, Gg, Gg, Gg, Gs, Rb, Gll, Gll, Gll^Fp, Gll^Fp, Gg^Fp, Gll^Fp, Gll^Fp, Gll^Fdw, Gll^Fp, Gll^Fp, Gll^Fp
Gll^Fp, Gll^Fp, Gll^Fp, Gs^Fp, Gs^Fp, Gg^Fp, Gg^Fmw, Gg^Fmw, Gs^Fp, Gg^Fp, Gg^Fp, Gg^Fp, Gg^Fp, Gll^Fmw, Gll^Fmw, Gll^Fp, Gll^Fp, Gll^Fp, Gll^Fp, Gll^Fp, Gll^Fp, Gll^Fp, Gll^Fp, Gs, Gg, Re, Gll^Fp, Gll^Fp, Gll^Fp, Gll^Fp, Gg^Fp, Gll^Fp, Gs^Fp, Gll^Fp, Gs^Fp, Gll^Fp, Gg^Fp, Gll^Fp, Gll^Fp, Gll^Fp, Gll^Fp, Gll, Gll^Fp, Gs, Gs, Rb, Gll, Gll^Fp, Gll^Fp, Gg^Fp, Gg^Fp, Gg^Fp, Gg^Fp, Gg^Fp, Gll^Fp, Gll^Fp, Gll^Fp
Gll^Fp, Gll^Fp, Gll^Fmw, Gs^Fmw, Gs^Fp, Gs^Fp, Gs^Fp, Gg^Fmw, Gll^Fp, Gg^Fp, Gs^Fp, Gs^Fp, Gs^Fp, Gll^Fmw, Gs^Fp, Gll^Fp, Gll^Fmw, Gll^Fmw, Gll^Fp, Gll^Fp, Gll^Fp, Gll^Fp, Gll, Gll, Re, Re, Gll^Fp, Gll^Fp, Gll^Fmw, Gg^Fmw, Gll^Fmw, Gg^Fp, Gs^Fp, Gg^Fp, Gs^Fmw, Gg^Fmw, Gll^Fmw, Gll^Fp, Gll^Fp, Gll^Fp, Gll^Fp, Gll^Fp, Gll^Fp, Gll^Fp, Gll^Fp, Rb, Gll^Fp, Gll^Fp, Gll^Fp, Gll^Fdw, Gll^Fp, Gll^Fp, Gll^Fp, Gll^Fp, Gg^Fp, Gll^Fp, Gll^Fp
Gll^Fp, Gll^Fp, Gll^Fmw, Gll^Fmw, Gs^Fp, Gs^Fp, Gs^Fp, Gll^Fp, Gll^Fmw, Gs^Fp, Gg^Fp, Gs^Fp, Gs^Fmw, Gs^Fp, Gs^Fp, Gg^Fp, Gll^Fmw, Gll^Fmw, Gll^Fp, Gll^Fp, Gll^Fp, Gll, Re, Re, Gll^Es, Gll, Gll^Fp, Gll^Fp, Gg^Fp, Gll^Fmw, Gll^Fp, Gs^Fp, Gg^Fp, Gs^Fmw, Gs^Fmw, Gs^Fmw, Gll^Fp, Gg^Fp, Gg^Fp, Gll^Fp, Gll^Fmw, Gll^Fmw, Gg^Fp, Gll^Fp, Gll^Fp, Re, Gll^Fp, Gll^Fp, Gll^Fp, Gll^Fp, Gs^Fp, Gs^Fp, Gg^Fmw, Gg^Fp, Gg^Fp, Gll^Fp, Gll^Fp
Gll^Fp, Gll^Fp, Gll^Fp, Gll^Fp, Gll^Fp, Gs^Fp, Gs^Fp, Gll^Fp, Gll^Fmw, Gll^Fp, Gll^Fp, Gs^Fmw, Gs^Fp, Gg^Fp, Gs^Fp, Gs^Fp, Gll^Fp, Gll^Fp, Gll^Fp, Gll^Fp, Gll, Gs, Ce, Gs, Gg, Gll, Gll^Vl, Gll^Fp, Gll^Fp, Gll^Fp, Gll^Fp, Gll^Fp, Gll^Fp, Gg^Fp, Gg^Fdw, Gg^Fp, Gg^Fp, Gll^Fp, Gs^Fp, Gll^Fp, Gll^Fmw, Gll^Fp, Gll^Fmw, Gll^Fp, Gll^Fp, Re, Gll^Fp, Gll^Fp, Gll^Fp, Gg^Fp, Gs^Fp, Gg^Fmw, Gs^Fmw, Gs^Fmw, Gs^Fp, Gll^Fp, Gll^Fp
Gll^Fp, Gll^Fp, Gll^Fp, Gll^Fp, Gs^Fdw, Gs^Fmw, Gs^Fp, Gs^Fp, Gll^Fp, Gll^Fp, Gll^Fmw, Gll^Fmw, Gll^Fmw, Gs^Fp, Gll^Fp, Gll^Fp, Gll^Fp, Gll^Fp, Gll^Fp, Gll^Fp, Gll, Ce, 1 Ke, Ce, Gs, Gll, Gll^Fp, Gll^Fp, Gll^Fp, Gll^Fp, Gs^Fp, Gll^Fp, Gll^Fp, Gll^Fp, Gs^Fp, Gs^Fp, Gs^Fmw, Gs^Fmw, Gs^Fmw, Gs^Fp, Gll^Fp, Gll^Fmw, Gg^Fmw, Gll^Fp, Gll^Fp, Re, Gll^Fp, Gll^Fp, Gg^Fp, Gll^Fp, Gs^Fp, Gg^Fp, Gs^Fp, Gs^Fp, Gs^Fp, Gs^Fp, Gll^Fp
Gll^Fp, Gll^Fp, Gll^Fp, Gs^Fp, Gs^Fmw, Gs^Fp, Gs^Fp, Gs^Fp, Gll^Fp, Gll^Fp, Gll^Fp, Gll^Fmw, Gll^Fp, Gll^Fp, Gll^Fp, Gll^Fp, Gll^Fp, Gll^Fp, Gll^Fp, Gll^Fp, Gll, Ce, Ce, Ce, Gs, Gll, Gll^Fp, Gll^Fp, Gll^Fmw, Gs^Fmw, Gs^Fp, Gs^Fp, Gll^Fmw, Gll^Fmw, Gs^Fp, Gs^Fp, Gs^Fp, Gs^Fmw, Gs^Fp, Gs^Fp, Gll^Fp, Gll^Fp, Gg^Fp, Gll^Fp, Gll^Fp, Re, Gll^Fp, Gll^Fp, Gg^Fp, Gll^Fmw, Gg^Fp, Gg^Fp, Gs^Fp, Gs^Fp, Gs^Fp, Gs^Fp, Gll^Fp
Gll^Fp, Gll^Fp, Gll^Fmw, Gs^Fp, Gs^Fp, Gs^Fp, Gs^Fp, Gs^Fmw, Gll^Fmw, Gll^Fp, Gll^Fp, Gll^Fp, Gs^Fmw, Gll^Fp, Gs^Fp, Gs^Fp, Gs^Fmw, Gll^Fmw, Gll^Fp, Gll^Fp, Gll, Gs, Rb, Gs, Gll^Fp, Gll^Fp, Gll^Fp, Gll^Fp, Gll^Fmw, Gs^Fmw, Gs^Fp, Gs^Fp, Gg^Fp, Gll^Fmw, Gs^Fp, Gs^Fp, Gs^Fp, Gs^Fp, Gs^Fp, Gll^Fp, Gg^Fp, Gg^Fp, Gll^Fdw, Gg^Fp, Gll^Fp, Re, Gll^Fp, Gll^Fp, Gll^Fp, Gg^Fmw, Gll^Fp, Gg^Fp, Gs^Fmw, Gs^Fmw, Gg^Fp, Gs^Fp, Gll^Fp
Gll^Fp, Gll^Fp, Gll^Fmw, Gs^Fmw, Gs^Fp, Gs^Fp, Gs^Fp, Gs^Fmw, Gll^Fp, Gll^Fp, Gll^Fp, Gs^Fp, Gs^Fmw, Gs^Fp, Gs^Fp, Gs^Fmw, Gs^Fp, Gs^Fp, Gll^Fp, Gll^Fp, Gll, Gll^Es, Rb, Gll, Gll^Fp, Gll^Fp, Gll^Fp, Gll^Fp, Gll^Fp, Gll^Fp, Gs^Fp, Gs^Fp, Gs^Fp, Gg^Fp, Gll^Fp, Gg^Fp, Gll^Fp, Gg^Fp, Gll^Fmw, Gg^Fmw, Gll^Fmw, Gll^Fp, Gll^Fp, Gll^Fp, Gll^Fp, Re, Gll^Fp, Gll^Fp, Gll^Fp, Gll^Fp, Gll^Fp, Gll^Fp, Gg^Fp, Gs^Fmw, Gg^Fp, Gg^Fp, Gll^Fp
Gll^Fp, Gll^Fp, Gll^Fp, Gll^Fp, Gll^Fp, Gll^Fp, Gll^Fp, Gll^Fp, Gll^Fp, Gll^Fp, Gll^Fp, Gs^Fp, Gs^Fmw, Gs^Fp, Gs^Fp, Gs^Fp, Gs^Fp, Gs^Fp, Gll^Fp, Gll, Gs, Gs, Re, Gll, Gll^Fp, Gll^Fp, Gll^Fp, Gll^Fp, Gs, Gs^Fp, Gll^Fp, Gs^Fp, Gll^Fp, Gll^Fp, Gll^Fp, Gll^Fp, Gg^Fmw, Gll^Fp, Gg^Fmw, Gll^Fp, Gll^Fp, Gll^Fp, Gll^Fp, Gll^Fp, Gll^Fp, Re, Gll^Fp, Gll^Fp, Gll^Fp, Gll^Fp, Gll^Fp, Gg^Fp, Gll^Fp, Gg^Fp, Gll^Fp, Gll^Fp, Gll^Fp
