border_size=1
usage=map

Mm, Mm, Mm, Mm, Mm, Mm, Mm, Mm, Mm, Mm, Hh, Mm, Mm, Mm, Mm, Mm, Mm, Mm, Mm, Mm, Mm, Mm, Hh, Mm, Mm, Mm, Mm, Mm, Hh, Hh, Hh^Fp, Hh^Fp, Hh^Fp, Hh^Fp, Gg, Gg, Gg, Gg, Gg, Gg, Gg, Gg, Gg, Gg, Gg, Gg
Mm, Mm, Mm, Mm, Hh, Hh, Hh, Hh, Hh, Hh, Hh, Hh, Hh, Mm, Hh, Mm, Hh, Hh, Hh, Mm, Hh, Hh, Hh, Hh, Hh, Mm, Mm, Mm, Hh, Hh, Hh^Fp, Hh^Fp, Hh^Fp, Hh^Fp, Gg, Gg, Gg, Gg, Gg, Gg, Gg, Gg, Gg, Gg, Gg, Gg
Mm, Mm, Mm, Mm, Hh, Hh, Hh, Hh, Gd, Gd, Gd^Emf, Hh, Hh, Hh, Hh, Hh, Hh, Hh, Hh, Hh, Gd, Gd, Gd, Hh, Gd, Hh, Hh, Hh, Hh, Hh, Gg, Gg, Gg, Gg, Gg, Gg, Gg, Gg, Gg, Gg, Gg, Gg, Gg, Gg, Ww, Ww
Mm, Mm, Mm, Mm, Hh, Hh, Co, Gd^Vo, Gd, Gd^Emf, Gd^Emf, Gd^Emf, Gd, Gd, Gd^Emf, Hh, Gd^Emf, Gd, Gd, Gd, Co, Gd^Vo, Gd, Ww, Ww, Gd, Gd, Gd, Gd, Gd, Gd, Gg, Gg, Gg, Ww, Ww, Ww, Gg, Gg, Gg, Gg, Gg, Ww, Ww, Gg, Gg
Mm, Mm, Mm, Hh, Gd^Vo, Co, 4 Ko, Co, Gd, Gd, Gd, Gd, Gd, Gd, Gd, Gd^Emf, Gd, Gd, Gd^Vo, Co, 6 Ko, Co, Gd, Gd, Gd, Ww, Gs^Vc, Gd, Gd, Gd, Gd, Gd, Ww, Ww, Gg, Gg, Gg, Ww, Ww, Gg, Ww, Ww, Gg, Gg, Gg, Gg
Mm, Mm, Mm, Hh, Gd, Co, Co, Co, Gd, Gd, Gd, Gd, Gs^Vc, Rr, Rr, Rr, Rr, Rr, Gd, Co, Co, Co, Gd, Gd, Gd, Ww, Ww, Gd, Gd, Gd, Ww, Ww, Gg, Gg, Gg, Gg, Gg, Gg, Gg, Ww, Gs, Gs, Gs, Gg, Gg, Gg
Mm, Mm, Hh, Hh, Gd, Gd, Gd, Gd^Vo, Rr, Gd, Rr, Rr, Gd, Gd, Gd, Gd, Gd, Gd, Gd, Gd, Rr, Gd^Vo, Rr, Gd, Gd, Gd, Gd, Ww, Ww, Ww, Gd, Gg, Gg, Gg, Gg, Gg, Gg, Gg, Gg, Gs, Ce, Gs, Gs, Gg, Gg, Gg
Mm, Mm, Hh, Hh, Gd, Gd, Gd, Gd, Gd, Rr, Rr, Gd^Dr, Gd, Gd, Gd, Gd, Gs^Vc, Rr, Rr, Rr, Gd, Gd, Gd, Rr, Gs^Vc, Gd, Gd, Gd, Gd, Gd, Gd, Gg, Gg, Gg, Gg, Gg, Gs, Gs, Gs, Ce, 7 Ket, Ce, Gs, Gs, Gg, Gg
Hh, Hh, Hh, Gd, Gd, Gd, Gd, Gd, Gd, Gd, Gs^Vc, Gd, Gd, Gd, Gd, Gd, Rr, Gd, Gd, Gd, Gd, Gd, Hh, Gd, Rr, Gd, Gd, Gd^Dr, Gd, Gd, Gd, Gg, Gll^Fp, Gll^Fp, Gll^Fp, Gs, Gs, Gs, Gs, Ce, Ce, Ce, Gs, Gs, Gg, Gg
Hh, Hh, Gd, Gd, Gd, Gd, Gd, Gd^Dr, Gd, Gd, Rr, Gd, Gd, Hh, Hh, Gd, Rr, Gd, Rr, Gd, Gs^Vc, Gd, Rr, Rr, Gd, Gd, Gd, Gd, Gd, Gd, Gll^Fp, Gll^Fp, Gll^Fp, Gll^Fp, Gll^Fp, Gll^Fp, Gll^Fp, Gs, Gs, Gs, Gs, Gs, Gs, Gs, Gg, Gg
Hh^Fp, Hh^Fp, Hh^Fp, Gd, Gd, Gd, Gd, Gd, Gd, Gd, Rr, Rr, Rr, Hh, Rr, Gd, Rr, Rr, Gd, Rr, Gd, Rr, Gd, Gd, Gd, Gd, Gd, Gd, Gll^Fp, Gll^Fp, Gll^Fp, Gll^Fp, Gll^Fp, Gll^Fp, Gll^Fp, Gll^Fp, Gll^Fp, Gs^Em, Gs^Em, Gs, Gs, Gs, Gll^Fp, Gs, Gg, Gg
Hh^Fp, Hh^Fp, Hh^Fp, Gd, Rr, Gs^Vc, Rr, Gd, Gd, Rr, Gd^Vo, Gd, Gd, Rr, Gd, Gs^Vc, Gd, Gd, Gd, Gd, Gd, Rr, Hh, Gd, Gd, Gs, Gs, Gll^Fp, Gll^Fp, Gll^Fp, Gll^Fp, Gll^Fp, Gll^Fp, Gll^Fp, Gll^Fp, Gll^Fp, Gs, Gs^Em, Gs^Em, Gs^Em, Gll^Fp, Gll^Fp, Gll^Fp, Gll^Fp, Gll^Fp, Gg
Rr, Hh^Fp, Rr, Rr, Gd, Gd, Gd, Rr, Co, Co, Co, Gd, Rr, Rr, Gd, Gd, Gd, Gd, Gd, Gd^Dr, Gd, Rr, Rr, Hh, Gs, Gs, Gs, Gll^Fp, Gll^Fp, Gll^Fp, Gll^Fp, Gll^Fp, Gll^Fp, Gll^Fp, Gll^Fp, Gll^Fp, Gs, Gs, Gll^Fp, Gll^Fp, Gll^Fp, Gll^Fp, Gll^Fp, Gll^Fp, Gll^Fp, Gll^Fp
Gg, Rr, Gg, Gg, Gd, Gd, Gd, Gd^Vo, Co, 5 Ko, Co, Gd^Vo, Gd, Gd, Gd, Gd, Gd, Gd, Gd, Gd, Gs, Gs, Gs, Rrc, Rrc, Gs, Gs, Gs, Gs, Gll^Fp, Gll^Fp, Gll^Fp, Gll^Fp, Gll^Fp, Gs, Gs, Gs^Es, Gs, Gll^Fp, Gll^Fp, Gll^Fp, Gll^Fp, Gll^Fp, Gll^Fp, Gll^Fp, Gll^Fp
Gg, Gg, Gg, Gg, Gg, Gd, Gd, Gd, Gd, Co, Gd, Gd, Gd, Gd, Gd, Gd, Gg, Hh, Gg, Gg, Gs, Gs, Gll^Fp, Gs, Gs, Rrc, Rrc, Gs, Gg, Gg, Gg, Gg, Gg, Gg, Gg, Gs^Es, Gs, Gs, Gll^Fp, Gll^Fp, Gll^Fp, Gll^Fp, Gll^Fp, Gll^Fp, Gll^Fp, Gll^Fp
Gg, Gg, Gg, Gg, Gg, Gg, Hh, Gd, Gd, Rr, Rr, Gd, Hh, Hh, Gg, Gg, Gg, Gg, Gg, Gg, Gll^Fp, Gll^Fp, Gll^Fp, Gll^Fp, Gll^Fp, Gs, Gs, Rrc, Rrc, Gg, Gg^Gvs, Gg^Gvs, Gg^Gvs, Gg, Gg, Gg, Gg, Gs, Gll^Fp, Gll^Fp, Gll^Fp, Gll^Fp, Gll^Fp, Gll^Fp, Gll^Fp, Gll^Fp
Gg, Gg, Gg, Gg, Gg, Gg, Gg, Gd, Gd, Gd, Gs^Vc, Gd, Gs, Gs, Gs, Gg, Gg, Gg, Gll^Fp, Gll^Fp, Gll^Fp, Gll^Fp, Gll^Fp, Gll^Fp, Gll^Fp, Gs, Gs, Gs, Rrc, Gg^Gvs, Gg^Gvs, Gg^Gvs, Gg^Gvs, Gg^Gvs, Gg, Gg, Gg, Gs, Gs, Gll^Fp, Gll^Fp, Gll^Fp, Gll^Fp, Gll^Fp, Gll^Fp, Gll^Fp
Gg, Gg, Gg, Gg, Gg, Gg, Gs, Gs, Gs, Gd, Rrc, Gs, Gs, Gs, Gg, Gs, Gll^Fp, Gll^Fp, Gll^Fp, Gll^Fp, Gll^Fp, Gll^Fp, Gll^Fp, Gll^Fp, Gll^Fp, Gs, Gs, Gs, Rrc, Gg, Gg^Vwm, Gg^Gvs, Gg, Gg, Gg, Gg, Gs, Gs^Vc, Gs, Gs, Rrc, Gg, Rrc, Gg, Rrc, Gg
Gg, Gg, Gg, Gg, Gs, Gs, Gs, Gs, Gs, Gs^Es, Rrc, Gs, Gs, Gs, Gg, Gll^Fp, Gll^Fp, Gll^Fp, Gll^Fp, Gll^Fp, Gll^Fp, Gll^Fp, Gll^Fp, Gll^Fp, Gg, Gg, Gg, Gs, Gg, Rrc, Rrc, Gg, Gs^Vh, Gg, Rrc, Gs, Rrc, Rrc, Rrc, Rrc, Gg, Rrc, Gg, Rrc, Gg, Rrc
Gg, Gg, Gg, Gg, Gs, Gs, Gs, Gs, Gs, Gs, Rrc, Gs^Es, Gs, Gs, Gs, Gs, Gs, Gll^Fp, Gll^Fp, Gll^Fp, Gll^Fp, Gll^Fp, Gs, Gs, Gg, Gg, Ch, Rr^Vhc, Gg, Gg, Ch, Ch, Ch, Rrc, Gs, Rrc, Gs, Gs, Gs, Gs, Gll^Fp, Gll^Fp, Gll^Fp, Gll^Fp, Gll^Fp, Gll^Fp
Gg, Gg, Gg^Fet, Gg, Gs, Gs, Gg^Fet, Gs, Gs, Gs, Rrc, Gs^Es, Gs, Gs, Gs, Gs, Gg, Gg, Gg, Gll^Fp, Gs, Gs, Gs, Gs, Rr^Vhc, Ch, 3 Kh, Ch, Rrc, Gs^Vh, Ch, 2 Kh, Ch, Gg, Gs, Gs^Vc, Gs, Gs, Gll^Fp, Gll^Fp, Gll^Fp, Gll^Fp, Gll^Fp, Gll^Fp, Gll^Fp, Gll^Fp
Gg, Gg, Gll^Fp, Gll^Fp, Gll^Fp, Gll^Fp, Gll^Fp, Gs, Gs, Gs, Gg, Rrc, Rrc, Gs, Gg, Gg, Gg^Gvs, Gg^Gvs, Gg^Gvs, Ww, Gg, Gs, Gg, Gg, Gg, Ch, Ch, Ch, Gg, Rrc, Rrc, Ch, Gs^Vh, Gg, Gs, Gs, Gs, Gs, Gll^Fp, Gll^Fp, Gll^Fp, Gll^Fp, Gll^Fp, Gll^Fp, Gll^Fp, Gll^Fp
Gll^Fp, Gll^Fp, Gll^Fp, Gll^Fp, Gll^Fp, Gll^Fp, Gll^Fp, Gll^Fp, Gll^Fp, Gg, Gg, Gg, Gg, Rrc, Gg, Gg^Gvs, Gg^Gvs, Gg^Gvs, Gg^Gvs, Gg^Gvs, Gg, Gg, Gg, Gg, Rrc, Rrc, Gg, Rr^Vhc, Gg, Gg, Rrc, Gg, Gs, Gg, Gs, Gs, Gs^Em, Gs^Em, Gll^Fp, Gll^Fp, Gll^Fp, Gll^Fp, Gll^Fp, Gll^Fp, Gll^Fp, Gll^Fp
Gll^Fp, Gll^Fp, Gll^Fp, Gll^Fp, Gll^Fp, Gll^Fp, Gll^Fp, Gll^Fp, Gll^Fp, Gg, Gg, Gg, Gg, Rrc, Rrc, Gg, Gg, Gg^Gvs, Gg, Gg^Vwm, Gg, Gg, Gg, Gg, Ch, Gs^Vh, Gg, Gg, Gg, Rrc, Gs, Gs, Gs, Gs, Gs^Vc, Gs, Gs, Gs^Em, Gs, Gll^Fp, Gll^Fp, Gll^Fp, Gll^Fp, Gll^Fp, Gll^Fp, Gll^Fp
Gll^Fp, Gll^Fp, Gll^Fp, Gll^Fp, Gll^Fp, Gll^Fp, Gll^Fp, Gll^Fp, Gll^Fp, Gg^Fet, Gg, Gg, Gg, Gg, Gs, Rrc, Rrc, Gg, Rrc, Rrc, Rrc, Gg, Gs^Vh, Ch, 1 Kh, Ch, Gg, Gg, Gg, Rrc, Gs, Gs, Gs, Gs, Gs, Gs, Gg, Gs, Gg, Gll^Fp, Gll^Fp, Gll^Fp, Gll^Fp, Gll^Fp, Gll^Fp, Gll^Fp
Gll^Fp, Gll^Fp, Gll^Fp, Gll^Fp, Gll^Fp, Gll^Fp, Gll^Fp, Gll^Fp, Gll^Fp, Gg, Gg, Gg, Gg, Gg, Gs, Gs, Gs, Rrc, Gs, Gg, Gs, Rrc, Rrc, Ch, Ch, Ch, Rrc, Gg, Gg, Rrc, Gs, Gs^Vc, Gs, Gs, Gs, Gs, Gg, Gg, Gg, Gg, Gg, Gll^Fp, Gll^Fp, Gll^Fp, Gll^Fp, Gll^Fp
Gll^Fp, Gll^Fp, Gll^Fp, Gll^Fp, Gll^Fp, Gll^Fp, Gll^Fp, Gll^Fp, Gll^Fp, Gg, Gg, Gg, Gg, Gg, Gs, Gs, Gs, Gs^Vc, Gs, Gs, Gs, Gs, Gg, Gg, Gs, Gs^Vh, Gs, Rrc, Rrc, Rrc, Gs^Es, Gs, Gg, Gs, Gg, Gg, Gg^Gvs, Gg^Gvs, Gg^Gvs, Gg, Gg^Wm, Gg, Gg, Gll^Fp, Gg, Gg
Gll^Fp, Gll^Fp, Gll^Fp, Gll^Fp, Gll^Fp, Gll^Fp, Gll^Fp, Gll^Fp, Gg^Fet, Gg, Gg, Gg, Gg, Gg, Gs, Gs, Gs, Gs, Gs, Gs, Gs, Gs^Vc, Gg, Gg, Gs, Gs, Gs, Gs^Es, Gs, Rrc, Rrc, Gs^Es, Gs, Gs, Gg, Gg^Gvs, Gg^Gvs, Gg^Gvs, Gg^Gvs, Gg^Gvs, Gg, Gg, Gg^Efm, Gg, Gg^Efm, Gg
Gll^Fp, Gll^Fp, Gll^Fp, Gll^Fp, Gll^Fp, Gll^Fp, Gll^Fp, Gll^Fp, Gg, Gg, Gg, Gg, Gg, Gg, Gg, Gs, Gs, Gs, Gs^Em, Gs^Em, Gs, Gs, Gg, Gg, Gg, Gg, Gg, Gs, Gg, Gg, Gg, Rrc, Rrc, Rrc, Rrc, Gg, Gg, Gg^Gvs, Gg, Gg, Gg, Gg^Efm, Gg^Efm, Gg^Efm, Gg^Efm, Gg^Efm
Gll^Fp, Gll^Fp, Gll^Fp, Gll^Fp, Gg^Fet, Gll^Fp, Gg, Gg, Gg, Gg, Gg, Gg, Gg, Gg, Gg, Gg, Gg, Gs, Gs, Gs^Em, Gg, Gg, Gg, Gg, Gg, Gg, Gg, Gg, Gg, Gg, Gg^Gvs, Gg, Gg^Wm, Gg, Gg, Rrc, Gg, Gg, Gg, Gg, Gg, Gg, Gg^Efm, Gg^Efm, Gg^Efm, Gg^Efm
Gg, Gg, Gg, Gg, Gg, Gg, Gg, Gg, Gg, Gg, Gg, Gg, Gg, Gg, Gg, Gg, Gg, Gg, Gg, Gg, Gg, Gg, Gg^Efm, Gg^Efm, Gg^Efm, Gg, Gg, Gg, Gg^Gvs, Gg^Gvs, Gg^Gvs, Gg^Gvs, Gg^Gvs, Gg, Gg, Rrc, Gg, Gg, Gg, Gg, Gg^Gvs, Gg^Wm, Gg, Gg^Efm, Gg^Efm, Gg^Efm
Ww, Ww, Ww, Gg, Gg, Gg, Ww, Ww, Ww, Ww, Ww, Gg, Gg, Gg, Gg, Gg, Gg, Gg, Gg, Gg, Gg^Efm, Gg^Efm, Gg^Efm, Gg^Efm, Gg^Efm, Gg^Efm, Gg^Efm, Gg, Gg, Gg^Gvs, Gg^Gvs, Gg^Gvs, Gg, Gg, Gg, Rrc, Gg, Gg, Gg^Gvs, Gg^Gvs, Gg^Gvs, Gg^Gvs, Gg^Gvs, Gg, Gg, Gg
Gg, Gg, Gg, Ww, Ww, Ww, Gg, Gg, Gg, Gg, Gg, Ww, Ww, Gg, Gg, Gg, Gg, Gg, Gg, Gg, Gg^Efm, Gg^Efm, Gg^Efm, Gg^Efm, Gg^Efm, Gg^Efm, Gg^Efm, Gg, Gg, Gg, Gg, Gg, Gg, Gg, Gg, Rrc, Gg, Gg, Gg, Gg^Gvs, Gg^Gvs, Gg^Gvs, Gg, Gg, Gg, Gg
Gg, Gg, Gg, Gg, Gg, Gg, Gg, Gg, Gg, Gg, Gg, Gg, Gg, Ww, Ww, Gg, Gg, Gg, Gg, Gg, Gg, Gg^Efm, Gg, Gg^Efm, Gg^Efm, Gg^Efm, Gg, Gg, Gg, Gg, Gg, Gg, Gg, Gg, Gg, Rrc, Gg, Gg, Gg, Gg, Gg, Gg, Gg, Gg, Gg, Gg
Gg, Gg, Gg, Gg, Gg, Gg, Gg, Gg, Gg, Gg, Gg, Gg, Gg, Gg, Gg, Ww, Ww, Gg, Gg, Gg, Gg, Gg, Gg, Gg, Gg, Gg^Efm, Gg, Gg, Gg, Gg, Gg, Gg, Gg, Gg, Gg, Rrc, Gg, Gg, Gg, Gg, Gg, Gg, Gg, Gg, Gg, Gg
