border_size=1
usage=map

Xos, Xos, Xos, Xos, Xos, Xos, Xos, Xos, Xos, Xos, Xos, Xos, Xos
Xos, Gs, Gs, Gs, Gs, Gs, Gs, Gs, Gs, Gs, Gs, Gs, Xos
Xos, Gs, Gs, Gs, Gs, Gs, Gs, 2 Gd^Vo, Gs, Gs, Gs, Gs, Xos
Xos, Gs, Gs, Gs, Gs, Gs, Gs, Gs, Gs, Gs, Gs, Gs, Xos
Xos, Gs, Gs, Gs, Gs, Gs, Co, Gs, Gs, Gs, Gs, Gs, Xos
Xos, Gs, Gs, Gs, Gs, Co, 1 Koa, Co, Gs, Gs, Gs, Gs, Xos
Gs, Xos, Xos, Gs, Gs, Co, Co, Co, Gs, Gs, Xos, Xos, Gs
Gs, Gs, Gs, Xos, Xos, Gs, Gs, Gs, Xos, Xos, Gs, Gs, Gs
Gs, Gs, Gs, Gs, Xos, Gs, Gs, Gs, Xos, Gs, Gs, Gs, Gs
