border_size=1
usage=map

Uu^Uf, Uu^Uf, Uu^Uf, Uu^Uf, Uu^Uf, Uu^Uf, Uu^Uf, Uu, Uu, Uu, Uu, Uu, Uu, Uu, Uu, Uu, Uu
Uu^Uf, Uu^Uf, Uu^Uf, Uu^Uf, Uu^Uf, Uu^Uf, Uu^Uf, Uu, Uu^Vu, Uu, 2 Kud, Uu, Uu^Vu, Uu, Uu, Uu, Uu
Uu^Uf, Uu^Uf, Uu^Uf, Uu^Uf, Uu^Uf, Uu^Uf, Uu^Uf, Uu, Uu, Uu, Uu, Uu, Uu, Uu, Uu^Vu, Uu, Uu
Uu^Uf, Uu^Uf, Uu^Uf, Uu^Uf, Uu^Uf, Uu^Uf, Uu^Uf, Uu, Uu, Uu, Uu, Uu, Uu, Uu, Uu, Uu, Uu^Uf
Uu^Uf, Uu^Uf, Uu^Uf, Uu^Uf, Uu^Uf, Uu^Uf, Uu^Uf, Uu, Cud, Cud, Cud, Uu, Uu, Uu, Uu^Uf, Uu^Uf, Uu^Uf
Uu^Uf, Uu^Uf, Uu^Uf, Uu^Uf, Uu^Uf, Uu^Uf, Uu, Uu, Cud, 1 Kud, Cud, Uu, Uu, Uu^Uf, Uu^Uf, Uu^Uf, Uu^Uf
Uu^Uf, Uu^Uf, Uu^Uf, Uu^Uf, Uu, Uu, Uu^Vu, Uu, Uu, Cud, Uu, Uu, Uu^Vu, Uu^Uf, Uu^Uf, Uu^Uf, Uu^Uf
Uu^Uf, Uu^Uf, Uu, Uu, Uu, Uu, Uu, Uu, Uu, Ur, Uu, Uu, Uu, Uu, Uu, Uu^Uf, Ur
Uu, Uu, Ur, Ur, Ur, Uu, Uu, Uu, Uu, Ur, Uu, Uu, Uu, Uu, Ur, Ur, Uu
Ur, Ur, Uu, Uu, Uu, Ur, Ur, Uu, Uu, Ur, Uu, Uu, Ur, Ur, Uu, Uu, Uu
Uu, Uu, Uu, Uu, Uu, Uu, Uu, Ur, Ur, Ur, Ur, Ur, Uu, Uu, Uu, Uu, Uu
Uu, Uu, Uu, Uu, Uu, Uu, Uu, Uu, Uu, Ur, Uu, Uu, Uu, Uu, Uu, Uu, Uu
Uu, Uu, Uu, Uu, Uu, Uu, Uu, Uu, Uu, Ur, Uu, Uu, Uu, Uu, Uu, Uu, Uu
Xu, Uu, Uu, Uu, Uu, Uu, Uu, Uu, Uu, Ur, Uu, Uu, Uu, Uu, Uu, Uu, Uu
Xu, Uu, Uu, Uu, Uu, Uu, Uu, Uu, Uu, 3 Ur, Uu, Uu, Uu, Uu, Uu, Uu, Uu
Xu, Uu, Uu, Uu, Uu, Uu, Uu, Uu, Uu, Ur, Uu, Uu, Uu, Uu, Uu, Uu, Uu
Xu, Uu, Uu, Uu, Uu, Uu, Uu, Uu, Uu, Ur, Uu, Uu, Uu, Uu, Uu, Uu, Xu
Xu, Xu, Xu, Uu, Uu, Uu, Uu, Uu, Uu, Ur, Uu, Uu, Uu, Uu, Xu, Xu, Xu
Xu, Xu, Xu, Xu, Xu, Uu, Uu, Uu, Uu, Ur, Uu, Uu, Xu, Xu, Xu, Xu, Xu
Xu, Xu, Xu, Xu, Xu, Xu, Xu, Uu, Uu, Ur, Uu, Uu, Xu, Xu, Xu, Xu, Xu
Xu, Xu, Xu, Xu, Xu, Xu, Xu, Uu, Uu, Ur, Uu, Uu, Xu, Xu, Xu, Xu, Xu
Xu, Xu, Xu, Xu, Xu, Xu, Xu, Uu, Uu, Ur, Uu, Uu, Xu, Xu, Xu, Xu, Xu
