border_size=1
usage=map

Mm, Mm, Mm, Gg, Mm, Mm, Mm, Mm, Hh, Gg, Gs, Gg, Gg, Gg, Gg, Gg, Gg, Gg, Gg, Gg, Gg^Gvs, Gg^Gvs, Gg^Gvs, Gg, Gs, Gg, Gg^Gvs, Gg^Gvs, Gg^Gvs, Gg^Gvs, Gg, Gg, Gg, Gg, Gg, Gg, Gg, Gg, Gg, Gg, Gg, Gg, Gg, Gg, Gg, Gg, Gg, Gg, Gg, Gg, Gg, Gg, Gg, Gg, Gg, Gg, Gg
Hh, Mm, Hh, Mm, Mm, Mm, Mm, Mm, Hh, Hh, Gs, Gs, Gd^Vhr, Gd, Gd, Gg, Gg, Gg, Gg, Gg, Gg, Gg^Gvs, Gs, Gs, Gs^Vh, Gs, Gs, Gg^Gvs, Gg, Gg, Gg, Gg, Gd, Gd, Gd, Gg, Gg^Dr, Gg, Gg, Gg, Gg, Gg, Gg, Gg, Gg, Gg, Gg, Gg, Gg, Gg, Gs, Gs, Gs, Gs, Gs, Gg, Gg
Hh, Hh, Hh, Hh, Hh, Hh, Hh, Mm, Hh, Gs, Gs, Gd, Gd, Gd, Gd^Dr, Gd, Gd^Vhr, Gg, Gll^Fdw, Gg, Gd, Gg, Gd, Gs, Gs, Gs, Gs, Gs^Vh, Gg, Gg, Gd^Vhr, Gd, Gd, Gd, Gd, Gd, Gs, Gs, Gs, Gg, Gs, Gg, Gd^Vhr, Gd, Gd, Gg, Gg, Gg, Gd, Gs, Gs, Gs, Gs, Gs, Gs, Gs, Gg
Gs, Hh, Gs, Gd, Gd, Gd, Gd, Hh, Gd, Gs^Dr, Gs, Gd, Gd, Gd, Gd, Gd, Gg, Gg, Gg, Gg, Gd, Gd, Gd, Gs, Gll, Gll^Fmf, Gs, Gs, Rr, Gd, Gd, Gd, Gd, Gs^Vh, Gd, Gd, Gs, Gs, Gs, Gs, Gs, Gs, Gs, Gd, Gd, Gd, Gd, Gd, Gd^Vhr, Gd, Gs, Gs, Gs, Gg^Ecf, Gs, Gs, Gg
Rr, Gs, Gs, Gd, Gd^Dr, Gd, Gd^Dr, Gd, Gs, Gs, Gs, Gs^Dr, Gg, Gd^Vhr, Gg, Gg, Rr, Gg, Gll^Fdw, Gg, Gd, Gd^Vhr, Gd, Gg, Gg, Gll, Rr, Rr, Hh, Rr, Rr, Gd, Gd, Gd, Gd, Gd, Gs, Gg, Gs, Gs, Gs, Gg^Ecf, Gs, Gs, Gd, Gd, Gd, Gd, Gd, Gd, Gd, Gs, Gs, Gs, Gd, Gd, Gd
Gg, Rr, Rr, Gs, Gs, Gs, Gs, Gs, Rr, Rr, Rr, Gg, Gg, Gg, Rr, Rr, Gll^Fmf, Rr, Gg, Gg, Gg, Gd, Gg, Gg, Rr, Rr, Gs, Hh, Gd, Gd, Gd, Rr, Rr, Gd, Gs, Gs, Gd, Gs, Gd^Vhr, Gs, Gs, Gs, Gd, Gd, Gd, Gd, Gd, Gd, Gd^Vhr, Gd, Gd, Gd, Gd, Gd, Gd^Vhr, Gd, Gg
Gg, Gg, Gg, 1 Rr, Rr, Gs, Rr, Rr, Hh, Hh, Hh, Rr, Rr, Rr, Gll^Fmf, Gll^Fmf, Gll^Fmf, Rr, Rr, Hh, Gg, Gll^Fdw, Rr, Rr, Gg^Es, Gg^Es, Gg^Es, Gs, Gg, Gd, Gd, Gd, Gd, Rr, Rr, Gd, Gd, Gd, Gs, Gs, Gs, Gs, Gs, Gd^Vhr, Gd, Gd, Gd, Gd, Gd, Gd, Gd, Gd^Vhr, Gd, Gd, Gd, Gd, Gs
Gg, Gg, Gg, Gg, Gll, Rr, Gll, Gll, Gll, Gll, Gs, Gs, Gs, Gll, Gll, Gg, Gll, Gll, Gll, Rr, Rr, Rr, Gs, Gs, Gs, Gg^Es, Gg, Gg, Gg, Gd, Gd, Gd, Gd, Gd, Gd^Dr, Rr, Gs, Gs, Gd, Gd, Gd, Gs, Gs, Gs, Hh, Hh, Rr, Rr, Rr, Rr, Rr, Gd, Gs, Gd, Rr, Rr, Rr
Gg, Gg, Gg, Gll, Gll, Gll, Gll^Fdf, Gll, Gll^Fdf, Gll, Gll, Gs, Gg^Emf, Gs, Gs, Gg, Gg, Gll, Gg, Gll^Fmf, Gll^Fmf, Gll^Fmf, Gs, Gs^Es, Gg, Gg, Gg, Gg, Gd, Gd, Gll^Fdw, Gll^Fdw, Gd^Fetd, Gd, Gd, Rr, Rr, Gs, Gd, Gd^Vhr, Gd, Gs, Gs, Gs, Rr, Rr, Hh, Hh, Hh, Hh, Gs, Rr, Rr, Rr, Gs, Gs, Gs
Gg, Gg, Gs, Gll, Gll^Fdf, Gll^Fdf, Gll^Fdf, Gll^Fdf, Gll^Fdf, Gll, Gg, Gg, Gg, Gg^Emf, Gg, Gg, Gg, Gg, Gll, Gll^Fmf, Gll, Gll, Gs, Gs^Es, Gs^Es, Gg, Gg, Gg, Gd, Gd, Gd, Gll^Fdw, Gll^Fdw, Gll^Fdw, Gll, Gd, Gd, Rr, Rr, Gd, Gd, Gd, Rr, Rr, Gd^Dr, Gd, Gd, Gd, Gd, Gd, Gs, Gs, Gs, Gs, Gs, Gs, Gg
Gg, Gs, Gs, Gs, Gll^Fdf, Gll^Fdf, Gll^Fdf, Gll^Fdf, Gll^Fdf, Gll^Fdf, Gg, Gg, Gg, Gg, Gg, Gg, Gg, Gg, Gg, Gll, Gll, Gll, Gg, Gs^Es, Gg, Gg, Gg, Gd, Gd, Gd, Gd, Gll^Fdw, Gll^Fdw, Gd^Fetd, Gll, Gll, Gd, Gd^Dr, Gd, Rr, Rr, Rr, Gd, Gd, Gd, Gd, Gs, Gd, Gs, Gs, Gd, Gd, Gd, Gs, Gd, Gs, Gg
Gg, Gs, Gs, Gs, Gs, Gll^Fdf, Gs, Gll^Fdf, Gs, Gs, Gg^Emf, Gg^Emf, Gg, Gg, Gg, Gg, Gs, Gs, Gs, Gg, Gg, Gg, Gg, Gg, Gg, Gg, Gd, Gd, Gs, Gd, Gs, Gd, Gd, Gll, Gll, Gll, Gll, Gd, Gd, Gd, Gd, Gd^Dr, Gd, Gd, Gd, Gs, Gs, Gd, Hh, Gd, Hh, Gd, Gd, Gd, Gd, Gd, Gd
Gg, Gg, Gg, Gs, Gs, Gs, Gs, Gs, Gs, Gs, Gg, Gg, Gg, Gg, Gg, Gs, Gs, Gs, Gs, Gs, Gg, Gg, Gg, Gg, Gg, Gg, Gd, Gs, Gs, Gs, Gs, Gs, Gd, Gll, Gll, Gll, Gd^Fetd, Gll, Gll^Fdw, Gd, Gd, Gd, Gd, Hh, Gd, Gs, Gs, Gd, Hh, Hh, Gs, Gs, Gs, Gd, Hh, Gd, Gd
Ww, Ww, Ww^Bw|r, Ww, Gg, Gs, Gg, Gs, Gg, Gg, Gg, Gg, Ww, Gg, Ww, Gg, Gs, Gs, Gs, Gs, Gs, Gg, Gg, Gg, Gg, Gg, Gd, Gs, Gs, Gg^Ecf, Gs, Gs, Gd, Gd, Gd, Gll^Fdw, Gll^Fdw, Gll^Fdw, Gd^Fetd, Gll^Fdw, Gll^Fdw, Gd, Gd, Hh, Gd, Gd, Gd, Gd, Gs, Gs, Gs, Gs, Gs, Hh, Hh, Gd, Gd
Ww, Ww, Ww^Bw|r, Ww, Wwf, Wwf, Ww^Ewf, Gg, Gg, Gg, Ww^Ewf, Ww, Ww, Wwf, Ww, Ww, Ww^Bw/r, Gs, Gs, Gs, Gs, Gg, Gg, Gg, Gd, Gd, Gd, Gs, Gs, Gs, Gs, Gs, Gd, Gd, Gd, Gd, Gd, Gll^Fdw, Gll^Fdw, Gll^Fdw, Gg, Gg, Gg, Gg, Gg, Gg, Gg, Gg, Gs, Gs, Gs, Gg^Ecf, Gs, Gg, Gg, Gs, Gs
Gg, Gg, Gg, Gg, Gg, Gg, Gg, Ww, Wwf, Wwf, Ww, Ww, Gg, Gg, Gg, Ww^Bw/r, Ww, Gg, Gg, Gs, Gg, Gg, Gg, Gg, Gd, Gd, Gd, Gd, Gd, Gd, Gd, Gd, Gd, Gd, Gd, Gd, Gd, Gg, Gg, Gg, Gg, Gg, Gg, Gg, Gg, Gg, Gg, Gg, Gg, Gs, Gs, Gs, Gs, Gg, Gg, Gs, Gg
Gg, Gg, Gg, Gg, Gg, Gg, Gg, Gg, Gg, Gg, Gg, Gg, Gg, Gg, Gg, Ww, Gg, Ww, Gg, Gg, Gg, Gg, Gg, Gg, Gg, Gd, Gg, Gd, Gg, Gd, Gg, Gd, Gg, Gd, Gg, Gd, Gg, Gg, Gg, Gg, Gg, Gg, Gg, Gg, Gg, Gg, Gg, Gg, Gg, Gg, Gg, Gs, Gg, Gg, Gg, Gg, Gg
