Gg, Gg, Gg, Gg, Gg, Gg, Gg, Gg, Gg, Gg, Gg, Gg, Gg, Gg, Gg, Gg, Gg, Gg, Gg, Gg, Gg, Gg, Gg, Gg, Rr, Gg, Gs, Gs, Gs, Gs, Gs, Gs, Gs, Gg, Gg, Gg, Gg, Gg, Gd, Gd, Gd, Gd, Hhd, Hhd, Md, Md, Md, Md, Md, Md, Md, Md, Md, Md, Md, Md, Md, Md, Md, Gg, Hhd, Gg
Hh, Hh, Hh, Gg, Gg, Gg, Gg, Gg, Gg, Gg, Gg, Gg, Gg, Gg, Gg, Gg, Gg, Gg, Gg, Gg, Gg, Gg, Gg, Gg, Rr, Gs, Gs, Gs, Gs, Gs, Gs, Gs, Gs, Gs, Gg, Gg, Gg, Gg, Gd, Gd, Gd, Gd, Hhd, Hhd, Md, Md, Md, Md, Md, Md, Md, Md, Md, Md, Md, Md, Md, Md, Md, Md, Md, Hhd
Hh, Hh, Hh, Hh, Hh, Gg, Gg, Gg, Gs, Gs, Gs, Gs, Gs, Gs, Gs, Gs, Gs, Gs, Gs, Gs, Gs, Gs, Gs, Gg, Gg, Rr, Gd, Gs, Gd, Gs, Gd, Gs, Gd, Gs, Gg, Gg, Gg, Gg, Gd, Gd, Gd, Gd, Hhd, Hhd, Md, Md, Md, Md, Md, Md, Md, Md, Md, Md, Md, Md, Md, Md, Md, Md, Md, Hhd
Mm, Mm, Mm, Hh, Hh, Hh, Hh, Gs, Gd, Gd, Gd, Gs, Rp^Vhcr, Gs, Gd, Gs, Gs, Gs, Gs, Gs, Gs, Gs, Gs, Gg, Gg, Rr, Gd, Gd, Gd, Gd, Gd, Gd, Gd, Gg, Gs, Gs, Gs, Gg, Gs, Gd, Gd, Gd, Gd, Hhd, Hhd, Md, Md, Md, Md, Md, Md, Md, Md, Md, Md, Md, Md, Md, Md, Md, Hhd, Hhd
Mm, Mm, Mm, Mm, Mm, Hh, Hh, Hh, Gd, Gd, Gd, Gd, Gd, Gd, Gd, Gd, Gs, Gs, Gs, Gs, Rp^Vhcr, Gs, Gd, Gg, Gg, Rr, Gd, Gd, Gd, Gd, Gd^Vhr, Gd, Gd, Gd, Gs, Gs, Gs, Gs, Gs, Gd, Gd^Vhr, Gd, Gd, Gd, Hhd, Hhd, Hhd, Hhd, Hhd, Md, Md, Md, Md, Md, Md, Md, Md, Md, Md, Md, Hhd, Hhd
Mm, Mm, Mm, Mm, Mm, Mm, Hh, Hh, Gd, Gd, Gd, Gd, Gd, Gd, Gd, Gd, Gs, Gs, Gs, Gd, Gd, Gd, Gd, Gd, Gd, Rr, Hhd, Gd, Gd, Gd, Gd, Gd, Gd, Gd, Gs, Gs, Gs, Gs, Gs, Gd, Gd, Gd, Gd, Gs, Gs, Hhd, Gs, Hhd, Hhd, Hhd, Hhd, Hhd, Hhd, Md, Hhd, Md, Hhd, Hhd, Hhd, Hhd, Hhd, Gd
Mm, Mm, Mm, Mm, Mm, Mm, Hh, Hh, Gd, Gd, Rp^Vhcr, Gd, Gd, Gd, Gd, Gd, Gs, Gs, Gs, Gd, Gd, Gd, Gd, Gd, Gd, Rr, Hhd, Hhd, Hhd, Gd, Gd, Gd, Rr, Gd, Rr, Gs, Rr, Gs, Gs, Gd, Gd, Gd, Gs, Gs, Gs, Gs, Gd, Gd, Gd, Hhd^Vhhr, Gd, Hhd, Gd, Hhd, Gs, Hhd, Gd, Hhd, Gd, Hhd, Gd, Gd
Mm, Mm, Mm, Mm, Mm, Mm, Hh, Hh, Gs, Gd, Gd, Gd, Gs, Gd, Rp^Vhcr, Gd, Gs, Gs, Gd, Gd, Gd, Gd, Hhd, Hhd, Hhd, Rr, Hhd, Hhd, Rr, Hhd, Rr, Rr, Gd, Rr, Gd, Rr, Gd, Rr, Rr, Gd, Gd, Gd, Gs, Gs, Gs, Gs, Gs, Gd, Gd, Gd, Gd, Gd, Gd, Gs, Gs, Gs, Gd, Gd, Gd, Gd, Gd, Gd
Mm, Mm, Mm, Mm, Hh, Hh, Hh, Hh, Gs, Gs, Gs, Gs, Gs, Gs, Gs, Gs, Gs, Gs, Gd, Gd, Gd, Hhd, Hhd, Hhd, Hhd, Rr, Rr, Rr, Gs, Rr, Gd, Gs, Gs, Gs, Gs, Gs, Gs, Gd, Gd, Rr, Rr, Gd, Rr, Gs, Gs, Gs, Gs, Gd, Gd, Gd, Gd, Gd, Hhd, Hhd, Hhd, Gs, Gs, Gd, Gd, Gd, Gd, Gd
Mm, Mm, Mm, Mm, Hh, Hh, Gg, Gg, Gg, Gs, Gs, Gs, Gs, Gs, Gs, Gs, Gs, Gs, Gs, Gd, Gs, Hhd, Hhd, Hhd, Hhd, Rr, Gs, Gs, Gs, Gd, Gs, Gs, Gs, Gs, Gs, Gs, Gs, Gd, Gd, Gs, Gs, Rr, Hhd, Rr, Rr, Gs, Gg, Gs, Gs, Gd, Gs, Gd, Rr, Rr, Rr, Gs, Gs, Gs, Gs, Gd, Gd, Gd
Mm, Mm, Mm, Mm, Hh, Hh, Gg, Gg, Gg, Gg, Gg, Gd, Gd, Gs, Gd, Gg, Gg, Gs, Gs, Gs, Gs, Gg, Hhd, Hhd, Hhd, Rr, Gs, Gs, Gs, Gs, Gs, Gs, Gs, Gs, Gs, Gs, Gs, Gs, Gs, Gs, Gs, Gs, Hhd, Hhd, Hhd, Rr, Rr, Gg, Gg, Gs, Rr, Rr, Gd, Gd, Gd, Rr, Rr, Gs, Gs, Gs, Gg, Gg
Mm, Mm, Mm, Mm, Hh, Hh, Gs, Gs, Gs, Gs, Gs, Gd, Gd, Gd, Gd, Gd, Gs, Gg, Gs, Gs, Gg, Gg, Gg, Hhd, Gg, Rr, Gd, Gd, Gd, Gs, Gd, Gd, Gd, Gs, Gs, Gs, Gs, Gs, Gs, Gs, Gs, Gs, Gd, Gd, Gd, Gd, Gd, Rr, Rr, Rr, Hhd, Hhd, Gd, Gd, Gd^Vhr, Gd, Gd, Rr, Rr, Gs, Gg, Gg
Mm, Mm, Hh, Hh, Hh^Vhh, Hh, Gs, Gs, Gs, Gs, Gs, Gd, Gd, Gd, Gs, Gs, Gs, Gs, Gs, Gs, Gd, Gg, Gg, Gg, Gg, Rr, Gd, Gd, Gll, Gll, Gll, Gd, Gd, Gd, Gs, Gs, Gs, Gs, Gs, Gs, Gd, Gd, Gd^Vhr, Gd, Gd, Gd, Gd, Gd, Gd, Hhd, Hhd, Hhd, Gs, Gd, Gd, Gd, Gd, Hhd, Hhd, Rr, Rr, Gg
Hh, Hh, Hh, Hh, Gd, Gd, Gd, Gs, Gs, Gs, Gs, Gd, Gd, Gd, Gs, Gs, Gd, Gd, Gd, Gd, Hhd, Gd, Gd, Gg, Rr, Rr, Gd, Gll, Gll^Fdw, Gll^Fdw, Gll^Fdw, Gd^Fetd, Gll, Gd, Gd, Gs, Gs, Gs, Gs, Hhd, Gd, Gd, Gd, Gd, Ss, Gd, Gd, Gd, Gd, Gd, Gd, Hhd, Gs, Gd, Gd, Gd, Gd, Gs, Gs, Hhd, Gd, Rr
Hh, Hh, Gd, Gd, Gd, Gd, Rr, Gd, Rr, Gs, Gs, Gs, Gs, Gs, Gs, Gs, Gd, Gd, Gd, Hhd, Hhd, Gd, Rr, Rr, Gs, Gd, Gd, Gd^Fetd, Gll^Fdw, Gll^Fdw, Gll^Fdw, Gll^Fdw, Gll, Gd, Gd, Gs, Gs, Gs, Gs, Hhd, Gd, Gd, Gd, Ss, Ss, Ss, Ss, Gd, Ss, Gd, Gd, Gd, Gs, Gs, Gs, Gd, Gs, Gs, Gd, Gd, Gd, Gd
Gd, Gd, Chr, Chr, Chr, Rr, Gd, Rr, Gs, Rr, Rr, Rr, Rr, Gs, Rr, Gg, Gd, Gd, Hhd, Hhd, Rr, Rr, Gs, Gs, Gd^Vhr, Gd, Gd, Gll, Gll^Fdw, Gll^Fdw, Gll^Fdw, Gll^Fdw, Gll, Gd, Gd, Gs, Gs, Gs, Gs, Hhd, Hhd, Gd, Gd, Ss, Ss, Ss, Ss, Ss, Ss, Ss, Gd, Gd, Gd, Gs, Gs, Gs, Gs, Gs, Gd, Gd, Gd, Gd
Gd, Chr, Chr, 1 Khr, Chr, Chr, Gd, Gd, Gs, Gs, Gs, Gs, Gg, Rr, Gg, Rr, Rr, Rr, Rr, Rr, Gs, Rr, Rr, Gs, Gs, Gd, Gd, Gll, Gll, Gll^Fdw, Gll, Gd^Fetd, Gd, Gd, Gd, Gd^Vhr, Gs, Gs, Gs, Gs, Gg, Gd, Gd, Gd, Gd, Ss, Ss, Ss, Ss, Ss, Gd, Gd, Gs, Gs, Gd, Gs, Gs, Gs, Gs, Gs, Gs, Gg
Gd, Rr, Gd, Chr, Gd, Gd, Gd, Gd^Vhr, Gs, Gs, Gs, Gs, Gs, Gs, Gs, Gg, Rr, Gs, Gs, Gs, Gs, Gs, Gs, Rr, Rr, Rr, Rr, Gd, Rr, Rr, Rr, Gd, Gd, Gd, Gs, Gs, Gs, Gs, Gs, Gg, Gg, Gg, Hhd, Gd, Gd, Gd, Gd, Ss, Gd, Gd, Gd, Hhd, Hhd, Gd, Gd, Gd^Vhr, Gd, Gs, Gs, Gs, Gs, Gs
Rr, Rr, Gd, Gd, Gd^Vhr, Gd, Gd, Gd, Gs, Gs, Gs, Gs, Gg, Gg, Gg, Gs, Rr, Gs, Gd, Gd, Gd, Gd, Gd, Gs, Gd, Gs, Gs, Rr, Gs, Gs, Gs, Rr, Rr, Rr, Rr, Gs, Gs, Gs, Gg, Gg, Rr, Hhd, Rr, Hhd, Rr, Gd, Gd, Gd, Gd, Gd, Gd, Gd, Hhd, Hhd, Rr, Gd, Gd, Gs, Gs, Gs, Gg, Gg
Gd, Gd, Gd^Vhr, Gd, Gd, Gd, Gd, Gd, Gg, Gs, Gs, Gs, Gg, Gg, Gg, Gg, Rr, Hhd, Hhd, Gd, Gd, Gd, Gd, Gd, Gd, Gd, Gd, Gs, Gd, Gs, Gs, Gs, Gg, Gg, Gs, Rr, Rr, Gg, Rr, Rr, Gd, Rr, Gd, Rr, Gd, Rr, Rr, Gd, Rr, Gd^Vhr, Gd, Hhd, Rr, Rr, Gs, Rr, Rr, Gs, Gg, Gg, Gg, Gg
Gd, Gd, Gd, Gd, Gd, Gd, Gs, Gg, Gg, Gg, Gg, Gg, Gg, Gs, Gs, Gs, Rr, Hhd, Hhd, Gd, Gd, Gd, Ss, Ss, Ss, Gd, Gd, Gd, Gd, Gs, Gg, Gg, Gg, Gs, Gs, Gs, Gs, Rr, Gd, Gd, Gd, Gd, Gll, Gll, Gll, Gd, Gd, Rr, Gd, Rr, Rr, Rr, Gd, Gd, Gd, Gs, Gs, Rr, Rr, Gg, Rr, Gg
Gg, Gd, Gs, Gd, Gs, Gs, Gs, Gs, Gd, Gg, Gd, Gd, Gd, Gs, Gs, Gs, Rr, Hhd, Hhd, Gd, Gd, Ss, Ss, Ss, Ss, Ss, Gd, Gd, Gd, Gd, Gg, Gg, Gs, Gs, Gs, Gs, Gs, Gs, Gd^Vhr, Gd, Gd, Gd, Gll, Gd^Fetd, Gll^Fdw, Gll, Gll, Gll, Gll, Gd, Gd, Gd, Gd, Gd, Gd, Gs, Gs, Gs, Gs, Rr, Gg, Rr
Gs, Gs, Gs, Gs, Gs, Gs, Gs, Gs, Gd, Gd, Gd, Gd, Gd, Gd, Gs, Gs, Gs, Rr, Rr, Gd, Gd, Ss, Ss, Ss, Gd, Ss, Gd, Gd, Gd, Gd, Gg, Gg, Gs, Gs, Gs, Gs, Gs, Gd, Gd, Gd, Gll, Gll, Gll^Fdw, Gll^Fdw, Gll^Fdw, Gll^Fdw, Gll^Fdw, Gll^Fdw, Gll^Fdw, Gll, Gll, Gll, Gll, Gd, Gd, Gs, Gs, Gs, Gs, Gs, Gg, Gg
Gs, Gs, Gs, Gs, Gs, Gs, Gs, Gs, Gd, Gd, Gd, Gd, Gd, Gd, Gd, Gs, Gs, Gs, Gs, Rr, Rr, Gd, Gd, Gd, Rr, Gd, Gd, Gd, Gd, Gg, Gg, Gs, Gs, Gs, Gs, Gs, Gs, Gd, Gd, Gd, Gll, Gll^Fdw, Gll^Fdw, Gll^Fdw, Gll^Fdw, Gll^Fdw, Gll^Fdw, Gll^Fdw, Gll^Fdw, Gll^Fdw, Gll^Fdw, Gll^Fdw, Gd^Fetd, Gd, Gd, Gs, Gs, Gs, Gs, Gs, Gg, Gg
Gs, Gs, Gs, Gs, Gs, Gs, Gg, Gg, Gd, Gd, Gd, Gd, Gd, Gd, Gd, Gd, Gs, Gs, Gs, Gs, Gd, Rr, Rr, Rr, Gd, Rr, Rr, Gd, Gs, Gg, Gs, Gs, Gs, Gs, Gs, Gs, Gs, Gd, Gd, Gll, Gd^Fetd, Gll^Fdw, Gll^Fdw, Gll^Fdw, Gll^Fdw, Gll^Fdw, Gll^Fdw, Gll^Fdw, Gll^Fdw, Gll^Fdw, Gll^Fdw, Gll^Fdw, Gd, Gd, Gd, Gs, Gs, Gs, Gs, Gs, Gg, Gg
Gs, Gs, Gs, Gs, Gg, Gg, Gd, Gd, Gd, Gd, Gd, Gd, Gd, Gd, Gd, Gd, Gs, Gs, Gd, Gd, Gd, Gd, Gd, Gd, Gd, Gs, Gs, Rr, Rr, Gg, Gs, Gs, Gs, Gs, Gs, Gs, Gd, Gd, Gd, Gll, Gll, Gll^Fdw, Gll^Fdw, Gll^Fdw, Gll^Fdw, Gll^Fdw, Gll, Gd^Fetd, Gll, Gll^Fdw, Gd, Gd, Gd, Gd, Gd, Gd, Gs, Gs, Gs, Gs, Gg, Gg
Gs, Gs, Gg, Gg, Gg, Gg, Gg, Gd, Gd, Gd, Gd, Gd, Gd, Gd, Gd, Gd, Gs, Gs, Gd, Gd, Gd, Gd, Gd, Gd, Gd, Gd, Gs, Gs, Gs, Rr, Rr, Gs, Gs, Gs, Gs, Gs, Gd, Gd, Gd, Gd, Gd, Gll, Gll, Gll, Gll, Gll, Gll, Gll, Gll, Gll, Gd, Gd, Gd, Gd, Gd, Gd, Gs, Gs, Gs, Gs, Gg, Gg
