Gg, Gg, Hhd, Md, Md, Md, Md, Md, Md, Md, Md, Md, Md, Md, Md, Md, Hhd, Hhd, Hhd, Gs, Rr, Gs, Gs, Gs, Gd, Gd, Gd, Gd, Gd, Gd, Gs, Gs, Gs, Gg, Gd, Gd, Gd, Gg, Gg, Gs, Hhd, Gg, Md, Gg, Md, Gg, Md, Md, Md, Md, Md, Md, Md, Md, Md, Md, Hhd
Gg, Hhd, Hhd, Hhd, Hhd, Md, Md, Md, Md, Md, Md, Md, Md, Md, Hhd, Hhd, Hhd, Hhd, Gd, Gs, Rr, Gs, Gs, Gs, Gd^Vhr, Gd, Gd, Gd, Gd, Gd, Rp^Vhcr, Gs, Gs, Gs, Rp^Vhcr, Gd, Gg, Gg, Gg, Gs, Hhd, Hhd, Md, Md, Md, Md, Md, Md, Md, Md, Md, Md, Md, Md, Hhd, Hhd, Hhd
Gd, Gd, Gd, Hhd, Hhd, Hhd, Hhd, Md, Hhd, Md, Hhd, Hhd, Hhd, Hhd, Hhd, Hhd, Gd, Gd, Gd, Gs, Rr, Gs, Gd, Gd, Gd, Gd, Gd, Gd, Gd, Gd, Gs, Gs, Chr, Gs, Gd, Gd, Gg, Gs, Gs, Gs, Hhd, Hhd, Hhd, Hhd, Hhd, Md, Md, Hhd, Hhd, Hhd, Hhd, Hhd, Hhd, Hhd, Hhd, Hhd, Gs
Gd, Gd, Gd, Gd, Gd, Hhd, Hhd, Hhd, Hhd, Hhd, Hhd, Hhd, Hhd, Hhd, Gg, Gd, Gs, Gd, Hhd, Hhd, Rr, Gd, Gs, Gd, Gd, Gd, Gd, Gd, Gd, Gd, Gs, Chr, 2 Khr, Chr, Gd, Gd, Gd, Gs, Gs, Gs, Gs, Hhd, Hhd, Hhd, Hhd, Hhd, Hhd, Hhd, Hhd, Hhd, Hhd, Hhd, Gd, Gs, Gs, Gs, Gs
Gd, Gd, Gd, Gd, Gd^Fetd, Gs, Gd, Hhd, Gd, Hhd, Gs, Gs, Gs, Gg, Gs, Gs, Gs, Gs, Hhd, Hhd, Rr, Hhd, Gs, Gd, Gd, Gd, Gd^Vhr, Gd, Gs, Rp^Vhcr, Gs, Chr, Chr, Chr, Gd, Rp^Vhcr, Gd, Gs, Gs, Gs, Gs, Gd, Gd, Gd, Gd, Hhd, Hhd, Gd, Gd, Gd, Gd, Gd, Gd, Gd, Gd, Gd, Gd
Gd, Gd, Gll^Fdw, Gll^Fdw, Gll^Fdw, Gll^Fdw, Gll^Fdw, Gd, Gs, Gs, Gd, Gs, Gd, Gg, Gs, Gs, Gs, Gs, Rr, Rr, Hhd, Hhd, Gs, Gd, Gd, Gd, Gs, Gs, Gs, Gs, Gd, Gs, Gs, Gs, Rp^Vhcr, Gd, Gs, Gs, Gs, Gs, Gs, Gd, Gd, Gd, Gd, Gd, Gd, Gd, Gd, Gd, Gll^Fdw, Gd^Fetd, Gll^Fdw, Gd, Gll^Fdw, Gd, Gd
Gd^Fetd, Gll^Fdw, Gll^Fdw, Gll^Fdw, Gll^Fdw, Gll^Fdw, Gll^Fdw, Gll^Fdw, Gd^Fetd, Gd, Gd, Gd, Gd, Gd, Gd, Gs, Rr, Rr, Gd, Gd, Gs, Gs, Gs, Gd, Gd^Vhr, Gd, Gs, Gs, Gs, Gd, Gd, Rp^Vhcr, Gd, Gs, Gs, Gs, Gs, Gs, Gs, Gs, Gs, Gs, Gs, Gd, Gd, Gd, Gd, Gd, Gll^Fdw, Gll^Fdw, Gll^Fdw, Gll^Fdw, Gll^Fdw, Gll^Fdw, Gll^Fdw, Gd, Gd
Gs, Gll^Fdw, Gll^Fdw, Gll^Fdw, Gd, Gll^Fdw, Gll^Fdw, Gll^Fdw, Gs, Gd, Gd, Gd, Gd, Gd, Rr, Rr, Hhd, Gd, Gd, Gd, Gs, Gs, Gd, Gd, Gd, Gs, Gs, Gs, Gd, Gd, Gd, Gd, Gs, Gs, Gs, Gs, Gs, Gg, Gd^Vhr, Gd, Gd, Gs, Gs, Gs, Gs, Gd, Gs, Gd^Fetd, Gll^Fdw, Gll^Fdw, Gll^Fdw, Gll^Fdw, Gll^Fdw, Gll^Fdw, Gd^Fetd, Gd, Gd
Gs, Gs, Gd, Gd, Gd, Gd, Gd, Gs, Rr, Hhd, Hhd, Gd, Rr, Rr, Rr, Hhd, Hhd, Gd, Gd, Gs, Gs, Gs, Gs, Gd, Gs, Gs, Gs, Gd, Gd, Gd, Gd, Gd, Gs, Gs, Gs, Gs, Gd, Gd, Gd, Gd, Gd, Gs, Gd, Gs, Gs, Gs, Gs, Hhd, Rr, Gll^Fdw, Rr, Rr, Rr, Hhd, Hhd, Gd, Gd
Gs, Gs, Gs, Gd, Gd^Vhr, Gd, Rr, Rr, Gs, Rr, Rr, Rr, Hhd, Hhd, Gd, Rr, Rr, Gd, Gd, Gs, Gs, Gs, Gd, Gs, Gs, Gs, Gs, Gd, Gd, Gd, Gd, Gd, Gs, Gs, Rr, Gd^Vhr, Gd, Gd, Gd, Gd, Gd, Gd, Gd^Vhr, Gd, Gs, Gs, Hhd, Rr, Hhd, Rr, Gll^Fdw, Hhd, Hhd, Rr, Rr, Gd, Gd
Rr, Rr, 1 Rr, Gs, Rr, Rr, Gd, Gs, Gll^Fdw, Gs, Gs, Gs, Gs, Hhd, Gd, Gd, Gs, Rr, Rr, Gs, Gd, Gd, Gd, Gd, Gs, Gs, Gd, Gd, Gd, Gd, Gd, Gs, Rr, Rr, Gs, Rr, Rr, Gd, Ce, Ce, Ce, Gd, Rr, Rr, Rr, Hhd, Rr, Hhd, Gd^Fetd, Gll^Fdw, Gll^Fdw, Gll^Fdw, Gll^Fdw, Gll^Fdw, Gll^Fdw, Rr, Rr
Gs, Gs, Gs, Rr, Gd, Gd, Gd, Gll^Fdw, Gll^Fdw, Gll^Fdw, Gd^Fetd, Gs, Gd, Gg, Gg, Gs, Gs, Gs, Gll^Fdw, Rr, Rr, Gd, Gd, Gd, Hhd, Gs, Gd, Gd, Rr, Rr, Rr, Rr, Gd, Gd, Gs, Gd, Gd, Rr, Ce, Ke, Ce, Rr, Gd, Gd, Gd, Rr, Gs, Gd, Gd, Gll^Fdw, Gll^Fdw, Gll^Fdw, Gll^Fdw, Gll^Fdw, Gll^Fdw, Gll^Fdw, Gd
Gd, Gd, Gd, Gd, Gd, Gd, Gll^Fdw, Gll^Fdw, Gll^Fdw, Gll^Fdw, Gll^Fdw, Gd, Gd, Gg, Gs, Gs, Gd^Fetd, Gll^Fdw, Gll^Fdw, Gll^Fdw, Gd^Fetd, Rr, Rr, Hhd, Hhd, Hhd, Rr, Rr, Gd, Gd, Gd, Gd, Gd, Gs, Gs, Gd, Gd, Gd, Gd, Ce, Gd, Gd, Gd^Vhr, Gd, Gs, Gs, Gs, Gd, Gd, Gd, Gd, Gll^Fdw, Gll^Fdw, Gll^Fdw, Gll^Fdw, Gll^Fdw, Gd
Gd, Gd, Gd, Gd^Vhr, Gd, Gd, Gll^Fdw, Gll^Fdw, Gll^Fdw, Gll^Fdw, Gll^Fdw, Gd, Gd, Gs, Gs, Gs, Gd, Gll^Fdw, Gll^Fdw, Gll^Fdw, Gll^Fdw, Gd, Hhd, Rr, Rr, Rr, Gs, Gs, Gs, Gd, Gd, Gd, Gs, Gs, Gs, Gs, Gs, Gd^Vhr, Gd, Gd, Gd^Vhr, Gd, Gg, Gs, Gs, Gs, Gd, Gd, Gd, Gd, Gd, Gd, Gs, Gd^Fetd, Gd, Gd, Gd
Gd, Gd, Gs, Gd, Gs, Gll^Fdw, Gll^Fdw, Gll^Fdw, Gll^Fdw, Gll^Fdw, Gll^Fdw, Gd^Fetd, Gd, Gs, Gs, Gd, Gd, Gd, Gd, Gll^Fdw, Gd, Gd, Hhd, Hhd, Rr, Gd^Fetd, Gll^Fdw, Gs, Gs, Gs, Gs, Gs, Gs, Gs, Gs, Gs, Gs, Gs, Gs, Gd, Gs, Gs, Gs, Gs, Gs, Gs, Gs, Gd, Gs, Gd, Gs, Gs, Gd, Gd, Gd, Gd, Gd
Gs, Gs, Gs, Gs, Gs, Gs, Gs, Gll^Fdw, Gll^Fdw, Gll^Fdw, Gd, Gd, Gd, Gs, Gs, Gs, Gs, Gd, Gd, Gd, Gd, Gd, Gd, Hhd, Rr, Gll^Fdw, Gll^Fdw, Gll^Fdw, Gd^Fetd, Gs, Gd, Gs, Gs, Gs, Gs, Gs, Gd, Gs, Gs, Gs, Gs, Gs, Gs, Gs, Gs, Gs, Gs, Gs, Gs, Gs, Gs, Gs, Gd, Gd, Gd, Gd, Gd
Gs, Gs, Gs, Gs, Gs, Gs, Gs, Gd^Fetd, Gd, Gd, Gd, Gd, Gd, Gd, Gs, Gs, Gs, Gs, Gd, Gd, Gd, Gd, Gd, Gd, Rr, Gll^Fdw, Gll^Fdw, Gll^Fdw, Gd, Gd, Gd, Gs, Gs, Gs, Gs, Gs, Gd^Vhr, Gd, Gd, Gd, Gd, Gs, Gs, Gs, Gs, Gs, Gs, Gs, Rp^Vhcr, Gs, Gs, Gs, Gd, Gd, Gd, Gd, Gd
Gs, Gs, Gs, Gs, Gs, Gs, Gs, Gs, Gd, Gd, Gd, Gd, Gd, Gd, Gg, Gs, Gs, Gs, Gd, Gd, Gd, Gd, Gs, Gs, Rr, Gd, Gd, Gd, Gg, Gd, Gs, Gs, Gs, Gs, Gs, Gd, Gd, Gd, Gd, Gd, Gd, Gs, Gs, Gs, Gs, Rp^Vhcr, Gd, Gd, Gd, Gd, Gd, Gs, Gs, Gd, Gd, Gd, Gd
Gg, Gs, Gg, Gs, Gs, Gs, Gs, Gs, Gs, Gd, Gd, Gd, Gg, Gg, Gg, Gg, Gs, Gs, Gs, Gs, Gs, Gs, Gs, Gs, Rr, Hhd, Hhd, Gs, Gs, Gs, Gs, Gs, Gs, Gs, Gs, Gd, Gd, Gd, Gd, Gd^Vhr, Gd, Gs, Gs, Gs, Rp^Vhcr, Gd, Chr, Chr, Chr, Gd, Rp^Vhcr, Gd, Gs, Gs, Gs, Gd, Gd
Gg, Gg, Gg, Gg, Gs, Gs, Gs, Gs, Gs, Gs, Gs, Gs, Gs, Gg, Gs, Gs, Gs, Gs, Gs, Gs, Gd, Gd, Gd, Gd, Rr, Hhd, Gd, Gd, Gd, Gd, Gd, Gs, Gs, Gs, Gs, Gd, Gd, Gd, Gd, Gd, Gd, Gs, Gs, Gs, Gs, Gd, Chr, 3 Khr, Chr, Gd, Gd, Gd, Gd, Gs, Gs, Gs, Gs
Gg, Gg, Gg, Gg, Gg, Gg, Gg, Gs, Gg, Gs, Gs, Gs, Gs, Gg, Gs, Gs, Gs, Gs, Gd, Gd, Gd, Gd, Gd, Hhd, Hhd, Rr, Gd, Gd, Gd, Gd, Gd, Gs, Gs, Gs, Gs, Gs, Gd, Gd^Vhr, Gd, Gd, Gd, Gd, Gs, Gs, Rp^Vhcr, Gd, Gd, Chr, Gd, Gd, Rp^Vhcr, Gd, Gd, Gs, Gs, Gs, Gs
Gg, Gg, Gg, Gg, Gg, Gg, Gg, Gg, Gg, Gg, Gs, Gs, Gs, Gs, Gs, Gs, Gs, Gs, Gd, Gd, Gd, Gd, Gd, Hhd, Gg, Rr, Gd, Gd, Gd, Gd, Gd, Gs, Gs, Gs, Gs, Gs, Gd, Gd, Gd, Gd, Gd, Gd, Gs, Gs, Gs, Gs, Gs, Gd, Gd, Gd, Gd, Gd, Gs, Gs, Gs, Gs, Gs
